customer_id,recency,frequency,monetary,R_rank,F_rank,M_rank,RFM_Score,segment,Cluster
1,8,11,9084.45,10,7,9,26,Best Customers,2
2,129,3,4149.07,2,1,3,6,Lost Customers,1
4,196,2,1047.72,1,1,1,3,Lost Customers,1
5,17,6,5903.2,8,4,6,18,Potential Loyalist,0
6,65,5,5931.6900000000005,4,3,6,13,At Risk,3
7,254,3,995.38,1,1,1,3,Lost Customers,1
8,23,9,9933.289999999999,8,6,9,23,Loyal Customers,2
9,79,6,5357.549999999999,3,4,5,12,At Risk,3
11,47,5,6026.8,5,3,6,14,At Risk,3
12,68,7,6394.21,4,5,6,15,Potential Loyalist,3
13,28,7,7734.74,7,5,8,20,Loyal Customers,2
14,48,3,2509.3900000000003,5,1,1,7,Lost Customers,1
15,36,6,4923.34,6,4,4,14,At Risk,0
16,100,5,7763.79,3,3,8,14,At Risk,3
17,1,5,4676.1900000000005,10,3,4,17,Potential Loyalist,0
18,135,7,8878.62,2,5,9,16,Potential Loyalist,3
19,281,2,2948.34,1,1,2,4,Lost Customers,1
20,32,4,6618.86,7,2,7,16,Potential Loyalist,0
21,7,5,7446.21,10,3,7,20,Loyal Customers,2
24,18,7,6885.51,8,5,7,20,Loyal Customers,2
25,6,12,9996.33,10,7,9,26,Best Customers,2
26,260,2,2245.85,1,1,1,3,Lost Customers,1
27,144,7,7679.97,2,5,8,15,Potential Loyalist,3
28,84,6,5492.900000000001,3,4,5,12,At Risk,3
29,23,9,10855.57,8,6,10,24,Loyal Customers,2
30,12,3,3736.5199999999995,9,1,3,13,At Risk,0
31,90,4,3110.0,3,2,2,7,Lost Customers,1
32,139,7,7873.18,2,5,8,15,Potential Loyalist,3
33,39,6,8808.96,6,4,9,19,Potential Loyalist,2
34,103,8,12098.83,3,6,10,19,Potential Loyalist,3
35,93,4,4182.28,3,2,3,8,Lost Customers,1
36,164,2,1781.04,1,1,1,3,Lost Customers,1
37,8,9,11291.71,10,6,10,26,Best Customers,2
38,51,4,4502.59,5,2,4,11,At Risk,1
39,35,12,11237.19,6,7,10,23,Loyal Customers,2
40,15,5,4882.43,9,3,4,16,Potential Loyalist,0
41,30,8,8570.1,7,6,9,22,Loyal Customers,2
42,112,4,1936.46,2,2,1,5,Lost Customers,1
43,62,9,6574.59,4,6,7,17,Potential Loyalist,3
44,36,7,7497.4,6,5,8,19,Potential Loyalist,2
45,44,3,2912.33,6,1,2,9,Lost Customers,0
46,54,5,4923.139999999999,5,3,4,12,At Risk,0
47,36,7,8022.01,6,5,8,19,Potential Loyalist,2
48,83,8,9654.119999999999,3,6,9,18,Potential Loyalist,3
49,37,4,5637.49,6,2,5,13,At Risk,0
50,27,7,7362.27,7,5,7,19,Potential Loyalist,2
51,56,8,9667.460000000001,5,6,9,20,Loyal Customers,3
52,5,6,9779.71,10,4,9,23,Loyal Customers,2
53,8,5,5472.74,10,3,5,18,Potential Loyalist,0
54,68,7,9813.66,4,5,9,18,Potential Loyalist,3
55,47,8,6754.21,5,6,7,18,Potential Loyalist,3
56,3,7,5060.86,10,5,4,19,Potential Loyalist,0
57,36,6,8748.75,6,4,9,19,Potential Loyalist,2
58,21,8,6967.3099999999995,8,6,7,21,Loyal Customers,2
59,23,3,2797.47,8,1,2,11,At Risk,0
60,201,2,1526.9,1,1,1,3,Lost Customers,1
61,48,6,7529.360000000001,5,4,8,17,Potential Loyalist,3
62,6,6,5845.950000000001,10,4,6,20,Loyal Customers,0
63,69,3,4156.66,4,1,3,8,Lost Customers,1
64,4,5,4111.12,10,3,3,16,Potential Loyalist,0
65,137,5,6421.17,2,3,6,11,At Risk,3
66,44,4,5199.48,6,2,5,13,At Risk,0
67,117,5,5304.15,2,3,5,10,At Risk,1
68,85,3,5127.98,3,1,5,9,Lost Customers,1
69,21,6,8395.75,8,4,8,20,Loyal Customers,2
70,5,5,4801.11,10,3,4,17,Potential Loyalist,0
71,132,1,1415.01,2,1,1,4,Lost Customers,1
72,23,4,4048.85,8,2,3,13,At Risk,0
73,169,6,5265.87,1,4,5,10,At Risk,3
74,29,3,2985.64,7,1,2,10,At Risk,0
75,61,8,7130.63,5,6,7,18,Potential Loyalist,3
76,2,8,7425.04,10,6,7,23,Loyal Customers,2
77,102,3,2964.73,3,1,2,6,Lost Customers,1
78,212,2,1139.12,1,1,1,3,Lost Customers,1
79,48,5,4918.51,5,3,4,12,At Risk,0
80,29,10,12564.82,7,7,10,24,Loyal Customers,2
81,5,4,4421.7,10,2,4,16,Potential Loyalist,0
82,79,5,5293.91,3,3,5,11,At Risk,3
83,81,6,4464.65,3,4,4,11,At Risk,1
84,29,7,5464.650000000001,7,5,5,17,Potential Loyalist,0
85,38,6,3158.6299999999997,6,4,2,12,At Risk,0
86,1,9,7319.35,10,6,7,23,Loyal Customers,2
87,19,9,7994.73,8,6,8,22,Loyal Customers,2
88,75,6,5550.83,4,4,5,13,At Risk,3
89,5,9,12741.44,10,6,10,26,Best Customers,2
90,31,7,7703.58,7,5,8,20,Loyal Customers,2
91,10,8,8066.4400000000005,9,6,8,23,Loyal Customers,2
92,35,3,5098.43,6,1,5,12,At Risk,0
93,80,3,5276.129999999999,3,1,5,9,Lost Customers,1
94,34,7,8305.77,7,5,8,20,Loyal Customers,2
95,39,4,5049.799999999999,6,2,4,12,At Risk,0
96,71,3,2783.33,4,1,2,7,Lost Customers,1
97,103,8,8895.95,3,6,9,18,Potential Loyalist,3
98,142,4,5405.52,2,2,5,9,Lost Customers,1
99,3,9,8279.06,10,6,8,24,Loyal Customers,2
100,12,2,2748.2,9,1,2,12,At Risk,0
101,9,4,4309.82,9,2,3,14,At Risk,0
102,43,7,6659.22,6,5,7,18,Potential Loyalist,3
103,117,4,4838.35,2,2,4,8,Lost Customers,1
104,65,7,6361.89,4,5,6,15,Potential Loyalist,3
105,90,4,6234.35,3,2,6,11,At Risk,3
106,2,3,2906.16,10,1,2,13,At Risk,0
107,82,4,3345.1000000000004,3,2,2,7,Lost Customers,1
108,11,3,3556.66,9,1,2,12,At Risk,0
109,9,10,10661.51,9,7,10,26,Best Customers,2
110,15,7,7788.71,9,5,8,22,Loyal Customers,2
111,148,4,4873.0599999999995,1,2,4,7,Lost Customers,1
112,48,6,9059.89,5,4,9,18,Potential Loyalist,3
113,176,5,4240.1900000000005,1,3,3,7,Lost Customers,1
114,71,4,3233.0,4,2,2,8,Lost Customers,1
115,15,8,8398.18,9,6,8,23,Loyal Customers,2
116,13,8,5663.92,9,6,5,20,Loyal Customers,2
117,6,10,12856.83,10,7,10,27,Best Customers,2
118,70,5,5319.51,4,3,5,12,At Risk,3
119,31,4,5217.66,7,2,5,14,At Risk,0
120,130,2,2173.3,2,1,1,4,Lost Customers,1
121,112,4,4327.44,2,2,3,7,Lost Customers,1
122,9,5,6533.389999999999,9,3,6,18,Potential Loyalist,0
123,192,4,5337.79,1,2,5,8,Lost Customers,1
124,3,7,8272.15,10,5,8,23,Loyal Customers,2
125,84,9,6537.76,3,6,6,15,Potential Loyalist,3
126,12,3,3448.12,9,1,2,12,At Risk,0
127,24,10,9949.62,8,7,9,24,Loyal Customers,2
128,138,4,3679.75,2,2,3,7,Lost Customers,1
129,179,4,4090.48,1,2,3,6,Lost Customers,1
130,77,2,3340.42,4,1,2,7,Lost Customers,1
131,206,6,8745.28,1,4,9,14,At Risk,3
132,8,6,7365.93,10,4,7,21,Loyal Customers,2
133,27,5,3164.55,7,3,2,12,At Risk,0
134,15,6,7170.95,9,4,7,20,Loyal Customers,2
135,116,6,4966.27,2,4,4,10,At Risk,1
136,21,8,9406.85,8,6,9,23,Loyal Customers,2
137,28,5,3507.0499999999997,7,3,2,12,At Risk,0
138,65,7,4927.35,4,5,4,13,At Risk,3
139,27,9,10638.89,7,6,10,23,Loyal Customers,2
140,4,6,7649.34,10,4,8,22,Loyal Customers,2
141,160,3,4053.9800000000005,1,1,3,5,Lost Customers,1
142,5,11,12474.74,10,7,10,27,Best Customers,2
143,14,4,4689.21,9,2,4,15,Potential Loyalist,0
144,7,8,8961.14,10,6,9,25,Best Customers,2
145,29,7,8149.19,7,5,8,20,Loyal Customers,2
146,195,2,1973.29,1,1,1,3,Lost Customers,1
147,35,6,8079.09,6,4,8,18,Potential Loyalist,3
148,44,5,5808.83,6,3,5,14,At Risk,0
149,19,4,4945.6900000000005,8,2,4,14,At Risk,0
150,76,4,3630.96,4,2,3,9,Lost Customers,1
151,1,7,11422.85,10,5,10,25,Best Customers,2
152,159,2,2941.37,1,1,2,4,Lost Customers,1
153,65,7,7808.16,4,5,8,17,Potential Loyalist,3
154,24,5,3521.5299999999997,8,3,2,13,At Risk,0
155,9,3,4008.51,9,1,3,13,At Risk,0
156,17,5,4831.58,8,3,4,15,Potential Loyalist,0
157,136,2,1248.96,2,1,1,4,Lost Customers,1
158,66,6,7221.05,4,4,7,15,Potential Loyalist,3
159,67,6,6016.32,4,4,6,14,At Risk,3
160,94,2,3024.58,3,1,2,6,Lost Customers,1
161,160,1,1148.64,1,1,1,3,Lost Customers,1
162,99,3,3317.47,3,1,2,6,Lost Customers,1
163,115,2,3089.24,2,1,2,5,Lost Customers,1
164,199,3,2583.85,1,1,1,3,Lost Customers,1
165,9,8,9603.13,9,6,9,24,Loyal Customers,2
166,64,7,8521.58,4,5,8,17,Potential Loyalist,3
167,15,9,9888.61,9,6,9,24,Loyal Customers,2
168,137,8,8563.42,2,6,9,17,Potential Loyalist,3
169,62,3,2065.08,4,1,1,6,Lost Customers,1
170,335,2,2555.62,1,1,1,3,Lost Customers,1
171,19,8,9347.85,8,6,9,23,Loyal Customers,2
172,12,7,9250.22,9,5,9,23,Loyal Customers,2
173,16,9,14061.48,8,6,10,24,Loyal Customers,2
174,12,10,12893.57,9,7,10,26,Best Customers,2
175,65,5,6008.03,4,3,6,13,At Risk,3
176,23,4,6146.7,8,2,6,16,Potential Loyalist,0
177,38,11,11184.03,6,7,10,23,Loyal Customers,2
178,33,4,3504.09,7,2,2,11,At Risk,0
179,41,3,3168.84,6,1,2,9,Lost Customers,0
180,12,7,7970.57,9,5,8,22,Loyal Customers,2
181,51,5,4262.27,5,3,3,11,At Risk,1
182,14,7,9279.01,9,5,9,23,Loyal Customers,2
183,103,6,5947.98,3,4,6,13,At Risk,3
184,33,3,3734.88,7,1,3,11,At Risk,0
185,9,7,9254.279999999999,9,5,9,23,Loyal Customers,2
186,24,6,5550.85,8,4,5,17,Potential Loyalist,0
187,15,7,6898.79,9,5,7,21,Loyal Customers,2
188,16,6,5126.07,8,4,5,17,Potential Loyalist,0
189,4,5,8633.69,10,3,9,22,Loyal Customers,2
190,208,3,3071.06,1,1,2,4,Lost Customers,1
191,106,1,1065.03,2,1,1,4,Lost Customers,1
192,80,4,3836.29,3,2,3,8,Lost Customers,1
193,25,5,7368.36,7,3,7,17,Potential Loyalist,2
194,109,3,4313.530000000001,2,1,3,6,Lost Customers,1
195,1,7,12479.46,10,5,10,25,Best Customers,2
196,147,8,6346.61,2,6,6,14,At Risk,3
197,28,9,8456.02,7,6,8,21,Loyal Customers,2
198,59,9,11648.85,5,6,10,21,Loyal Customers,3
199,16,4,4323.860000000001,8,2,3,13,At Risk,0
200,8,9,11117.36,10,6,10,26,Best Customers,2
201,29,7,8208.64,7,5,8,20,Loyal Customers,2
202,19,3,2511.82,8,1,1,10,At Risk,0
203,12,5,4376.26,9,3,3,15,Potential Loyalist,0
204,28,8,11444.0,7,6,10,23,Loyal Customers,2
205,53,9,6904.88,5,6,7,18,Potential Loyalist,3
206,78,4,5633.8099999999995,4,2,5,11,At Risk,1
207,291,2,2638.26,1,1,2,4,Lost Customers,1
208,28,5,5158.98,7,3,5,15,Potential Loyalist,0
209,108,5,6093.4800000000005,2,3,6,11,At Risk,3
210,23,6,8805.2,8,4,9,21,Loyal Customers,2
211,40,9,10073.76,6,6,10,22,Loyal Customers,2
212,188,2,2429.8,1,1,1,3,Lost Customers,1
213,29,10,11681.59,7,7,10,24,Loyal Customers,2
214,57,5,5776.95,5,3,5,13,At Risk,3
215,4,8,8485.16,10,6,8,24,Loyal Customers,2
216,17,4,4801.610000000001,8,2,4,14,At Risk,0
217,5,7,9487.89,10,5,9,24,Loyal Customers,2
218,15,4,3125.6,9,2,2,13,At Risk,0
219,41,6,6156.27,6,4,6,16,Potential Loyalist,3
220,16,6,7458.69,8,4,8,20,Loyal Customers,2
221,19,6,6729.84,8,4,7,19,Potential Loyalist,2
222,21,2,2626.81,8,1,2,11,At Risk,0
223,53,6,8743.94,5,4,9,18,Potential Loyalist,3
224,2,5,4216.53,10,3,3,16,Potential Loyalist,0
225,38,3,2416.13,6,1,1,8,Lost Customers,0
226,117,2,1639.95,2,1,1,4,Lost Customers,1
227,27,5,5589.13,7,3,5,15,Potential Loyalist,0
228,78,5,5178.17,4,3,5,12,At Risk,3
229,61,5,4473.07,5,3,4,12,At Risk,0
230,37,10,10591.710000000001,6,7,10,23,Loyal Customers,2
231,46,4,5338.64,6,2,5,13,At Risk,0
232,142,6,4132.44,2,4,3,9,Lost Customers,1
233,18,6,5218.62,8,4,5,17,Potential Loyalist,0
234,12,9,11070.19,9,6,10,25,Best Customers,2
235,3,11,9629.61,10,7,9,26,Best Customers,2
236,7,4,5255.34,10,2,5,17,Potential Loyalist,0
237,27,8,7156.79,7,6,7,20,Loyal Customers,2
238,108,5,5838.6,2,3,6,11,At Risk,3
239,2,9,12986.130000000001,10,6,10,26,Best Customers,2
240,89,5,4449.22,3,3,4,10,At Risk,1
241,48,4,3855.87,5,2,3,10,At Risk,1
242,132,7,7798.25,2,5,8,15,Potential Loyalist,3
243,75,5,6741.57,4,3,7,14,At Risk,3
244,195,3,4356.25,1,1,3,5,Lost Customers,1
245,13,5,4855.26,9,3,4,16,Potential Loyalist,0
246,28,9,9724.98,7,6,9,22,Loyal Customers,2
247,113,7,9778.37,2,5,9,16,Potential Loyalist,3
248,135,6,8368.65,2,4,8,14,At Risk,3
249,48,9,6569.14,5,6,7,18,Potential Loyalist,3
250,32,6,8100.97,7,4,8,19,Potential Loyalist,2
251,39,4,3425.0,6,2,2,10,At Risk,0
252,63,5,5565.48,4,3,5,12,At Risk,3
253,18,4,2189.85,8,2,1,11,At Risk,0
254,42,7,9801.07,6,5,9,20,Loyal Customers,2
255,58,11,14027.76,5,7,10,22,Loyal Customers,2
256,1,5,5861.16,10,3,6,19,Potential Loyalist,0
257,93,5,7616.05,3,3,8,14,At Risk,3
258,19,5,4816.4,8,3,4,15,Potential Loyalist,0
259,28,4,5329.9400000000005,7,2,5,14,At Risk,0
260,9,9,8587.0,9,6,9,24,Loyal Customers,2
261,51,9,9137.67,5,6,9,20,Loyal Customers,3
262,11,5,4597.37,9,3,4,16,Potential Loyalist,0
263,47,7,7902.84,5,5,8,18,Potential Loyalist,3
264,131,3,1111.79,2,1,1,4,Lost Customers,1
265,80,4,4809.14,3,2,4,9,Lost Customers,1
266,33,4,4191.43,7,2,3,12,At Risk,0
267,131,4,5029.25,2,2,4,8,Lost Customers,1
268,70,4,5104.56,4,2,5,11,At Risk,1
269,169,5,5215.37,1,3,5,9,Lost Customers,1
270,8,7,7413.610000000001,10,5,7,22,Loyal Customers,2
271,203,2,2293.0200000000004,1,1,1,3,Lost Customers,1
272,92,7,7345.17,3,5,7,15,Potential Loyalist,3
273,29,10,11372.24,7,7,10,24,Loyal Customers,2
274,150,4,2597.6800000000003,1,2,2,5,Lost Customers,1
275,133,6,8841.83,2,4,9,15,Potential Loyalist,3
276,4,6,6112.08,10,4,6,20,Loyal Customers,0
277,22,3,3580.48,8,1,2,11,At Risk,0
278,249,1,1228.07,1,1,1,3,Lost Customers,1
279,15,6,3817.17,9,4,3,16,Potential Loyalist,0
280,44,10,10822.28,6,7,10,23,Loyal Customers,2
281,10,4,3537.46,9,2,2,13,At Risk,0
282,70,2,2565.84,4,1,1,6,Lost Customers,1
283,92,5,7164.45,3,3,7,13,At Risk,3
284,134,5,5874.839999999999,2,3,6,11,At Risk,3
285,8,6,6725.29,10,4,7,21,Loyal Customers,2
286,156,3,4424.7,1,1,4,6,Lost Customers,1
288,45,4,3936.5699999999997,6,2,3,11,At Risk,0
289,45,9,9320.12,6,6,9,21,Loyal Customers,2
290,12,5,5912.93,9,3,6,18,Potential Loyalist,0
291,41,2,983.55,6,1,1,8,Lost Customers,0
292,59,7,8825.97,5,5,9,19,Potential Loyalist,3
293,11,5,5175.56,9,3,5,17,Potential Loyalist,0
294,116,7,8719.14,2,5,9,16,Potential Loyalist,3
295,35,7,5956.46,6,5,6,17,Potential Loyalist,3
296,9,3,4016.36,9,1,3,13,At Risk,0
297,9,4,5674.71,9,2,5,16,Potential Loyalist,0
298,9,9,10336.31,9,6,10,25,Best Customers,2
299,93,7,10296.12,3,5,10,18,Potential Loyalist,3
300,157,5,7003.74,1,3,7,11,At Risk,3
301,94,2,361.78,3,1,1,5,Lost Customers,1
302,277,1,1661.92,1,1,1,3,Lost Customers,1
303,44,3,3874.1800000000003,6,1,3,10,At Risk,0
304,81,9,7284.7,3,6,7,16,Potential Loyalist,3
305,34,6,5206.26,7,4,5,16,Potential Loyalist,0
306,124,2,1362.46,2,1,1,4,Lost Customers,1
307,16,8,8042.1900000000005,8,6,8,22,Loyal Customers,2
308,26,6,7432.02,7,4,7,18,Potential Loyalist,2
309,10,4,5475.93,9,2,5,16,Potential Loyalist,0
310,9,7,9065.04,9,5,9,23,Loyal Customers,2
311,62,6,7559.06,4,4,8,16,Potential Loyalist,3
312,14,5,6921.42,9,3,7,19,Potential Loyalist,2
313,18,6,8979.0,8,4,9,21,Loyal Customers,2
314,21,8,6264.7300000000005,8,6,6,20,Loyal Customers,2
315,28,9,7677.51,7,6,8,21,Loyal Customers,2
316,12,4,3813.84,9,2,3,14,At Risk,0
317,81,4,5779.950000000001,3,2,5,10,At Risk,1
318,10,7,9276.07,9,5,9,23,Loyal Customers,2
319,72,5,7051.54,4,3,7,14,At Risk,3
320,13,10,11721.06,9,7,10,26,Best Customers,2
321,13,5,5405.99,9,3,5,17,Potential Loyalist,0
322,2,11,14770.220000000001,10,7,10,27,Best Customers,2
323,36,6,4992.110000000001,6,4,4,14,At Risk,0
324,22,5,2711.14,8,3,2,13,At Risk,0
325,134,6,7543.92,2,4,8,14,At Risk,3
326,162,3,3419.08,1,1,2,4,Lost Customers,1
327,17,5,6108.21,8,3,6,17,Potential Loyalist,0
328,5,8,5739.53,10,6,5,21,Loyal Customers,2
329,35,6,5425.24,6,4,5,15,Potential Loyalist,0
330,108,6,8513.2,2,4,8,14,At Risk,3
331,83,6,7052.26,3,4,7,14,At Risk,3
332,264,2,1362.46,1,1,1,3,Lost Customers,1
333,23,6,5889.4,8,4,6,18,Potential Loyalist,0
334,57,6,6125.9,5,4,6,15,Potential Loyalist,3
335,25,2,2234.34,7,1,1,9,Lost Customers,0
336,83,5,3711.9500000000003,3,3,3,9,Lost Customers,1
337,38,6,5855.57,6,4,6,16,Potential Loyalist,3
338,11,7,8578.51,9,5,9,23,Loyal Customers,2
339,59,5,6459.18,5,3,6,14,At Risk,3
340,31,8,8079.91,7,6,8,21,Loyal Customers,2
341,135,2,3532.9399999999996,2,1,2,5,Lost Customers,1
342,94,3,1960.04,3,1,1,5,Lost Customers,1
343,134,8,9085.16,2,6,9,17,Potential Loyalist,3
344,9,9,11386.87,9,6,10,25,Best Customers,2
345,20,7,7446.139999999999,8,5,7,20,Loyal Customers,2
346,13,9,8874.36,9,6,9,24,Loyal Customers,2
347,60,7,12360.26,5,5,10,20,Loyal Customers,3
348,126,6,5562.58,2,4,5,11,At Risk,3
349,167,5,4619.93,1,3,4,8,Lost Customers,1
350,5,6,4728.13,10,4,4,18,Potential Loyalist,0
351,12,2,2832.11,9,1,2,12,At Risk,0
352,26,6,8533.27,7,4,9,20,Loyal Customers,2
353,24,11,13721.09,8,7,10,25,Best Customers,2
354,68,6,5392.11,4,4,5,13,At Risk,3
355,46,5,4674.02,6,3,4,13,At Risk,0
356,62,5,5765.9,4,3,5,12,At Risk,3
357,16,8,8779.220000000001,8,6,9,23,Loyal Customers,2
358,71,2,2129.82,4,1,1,6,Lost Customers,1
359,9,10,8564.63,9,7,9,25,Best Customers,2
360,9,5,6069.39,9,3,6,18,Potential Loyalist,0
361,147,7,6592.67,2,5,7,14,At Risk,3
362,90,4,1612.51,3,2,1,6,Lost Customers,1
363,15,6,11621.14,9,4,10,23,Loyal Customers,2
364,12,6,6791.39,9,4,7,20,Loyal Customers,2
365,51,7,8188.29,5,5,8,18,Potential Loyalist,3
366,116,6,5867.110000000001,2,4,6,12,At Risk,3
367,44,5,5068.58,6,3,4,13,At Risk,0
368,14,9,9300.06,9,6,9,24,Loyal Customers,2
369,102,8,9536.35,3,6,9,18,Potential Loyalist,3
370,112,7,7633.95,2,5,8,15,Potential Loyalist,3
371,10,5,6859.8,9,3,7,19,Potential Loyalist,2
372,32,8,6870.42,7,6,7,20,Loyal Customers,2
373,224,1,1466.68,1,1,1,3,Lost Customers,1
374,14,6,7756.64,9,4,8,21,Loyal Customers,2
375,92,4,3460.33,3,2,2,7,Lost Customers,1
376,44,3,1981.8899999999999,6,1,1,8,Lost Customers,0
377,7,11,9343.58,10,7,9,26,Best Customers,2
378,125,7,5827.91,2,5,5,12,At Risk,3
379,146,2,2849.83,2,1,2,5,Lost Customers,1
380,36,8,10261.59,6,6,10,22,Loyal Customers,2
381,3,8,8019.8,10,6,8,24,Loyal Customers,2
382,36,7,6536.92,6,5,6,17,Potential Loyalist,3
383,52,3,3922.8999999999996,5,1,3,9,Lost Customers,1
384,86,5,5068.24,3,3,4,10,At Risk,1
385,79,9,10758.23,3,6,10,19,Potential Loyalist,3
386,67,5,5445.4400000000005,4,3,5,12,At Risk,3
387,32,3,5303.1,7,1,5,13,At Risk,0
388,56,3,2857.55,5,1,2,8,Lost Customers,1
389,114,6,3948.4300000000003,2,4,3,9,Lost Customers,1
390,77,4,1830.56,4,2,1,7,Lost Customers,1
391,57,4,3132.87,5,2,2,9,Lost Customers,1
392,102,7,8157.6,3,5,8,16,Potential Loyalist,3
393,147,2,2728.3599999999997,2,1,2,5,Lost Customers,1
394,46,8,7818.74,6,6,8,20,Loyal Customers,2
395,31,6,6571.34,7,4,7,18,Potential Loyalist,2
396,30,6,6560.6900000000005,7,4,7,18,Potential Loyalist,2
397,46,5,3791.1,6,3,3,12,At Risk,0
398,13,6,4088.0899999999997,9,4,3,16,Potential Loyalist,0
399,94,5,6823.9,3,3,7,13,At Risk,3
400,135,5,4266.01,2,3,3,8,Lost Customers,1
401,30,7,7478.68,7,5,8,20,Loyal Customers,2
402,57,6,8148.22,5,4,8,17,Potential Loyalist,3
403,57,5,4228.4400000000005,5,3,3,11,At Risk,1
404,19,8,9102.380000000001,8,6,9,23,Loyal Customers,2
405,15,6,7468.88,9,4,8,21,Loyal Customers,2
406,107,5,5322.95,2,3,5,10,At Risk,1
407,10,9,7837.83,9,6,8,23,Loyal Customers,2
408,18,5,5252.97,8,3,5,16,Potential Loyalist,0
409,14,4,3610.11,9,2,2,13,At Risk,0
410,7,7,5472.9,10,5,5,20,Loyal Customers,0
411,188,5,5130.24,1,3,5,9,Lost Customers,1
412,28,3,3041.12,7,1,2,10,At Risk,0
413,168,5,5306.63,1,3,5,9,Lost Customers,1
414,48,6,4770.45,5,4,4,13,At Risk,0
415,249,2,3670.0,1,1,3,5,Lost Customers,1
416,89,4,3114.4700000000003,3,2,2,7,Lost Customers,1
417,71,7,8689.25,4,5,9,18,Potential Loyalist,3
418,29,6,6298.139999999999,7,4,6,17,Potential Loyalist,0
419,15,7,7917.43,9,5,8,22,Loyal Customers,2
420,60,10,11080.54,5,7,10,22,Loyal Customers,2
421,57,6,7222.93,5,4,7,16,Potential Loyalist,3
422,134,4,5465.0,2,2,5,9,Lost Customers,1
423,142,5,5058.62,2,3,4,9,Lost Customers,1
424,75,6,7857.62,4,4,8,16,Potential Loyalist,3
425,26,7,10925.23,7,5,10,22,Loyal Customers,2
426,60,8,8616.47,5,6,9,20,Loyal Customers,3
427,110,4,4678.55,2,2,4,8,Lost Customers,1
428,52,8,9009.45,5,6,9,20,Loyal Customers,3
429,19,7,6737.38,8,5,7,20,Loyal Customers,2
430,66,6,7494.51,4,4,8,16,Potential Loyalist,3
431,139,1,1289.85,2,1,1,4,Lost Customers,1
432,22,8,9237.06,8,6,9,23,Loyal Customers,2
433,16,8,8961.9,8,6,9,23,Loyal Customers,2
434,298,2,1945.46,1,1,1,3,Lost Customers,1
435,103,4,5669.1,3,2,5,10,At Risk,1
436,51,3,3374.59,5,1,2,8,Lost Customers,1
437,49,6,5595.76,5,4,5,14,At Risk,3
438,52,8,12777.29,5,6,10,21,Loyal Customers,3
439,100,5,5412.13,3,3,5,11,At Risk,3
440,12,8,7773.05,9,6,8,23,Loyal Customers,2
441,63,3,2910.7200000000003,4,1,2,7,Lost Customers,1
442,14,7,5714.68,9,5,5,19,Potential Loyalist,0
443,206,6,6781.389999999999,1,4,7,12,At Risk,3
444,46,7,7147.11,6,5,7,18,Potential Loyalist,3
445,25,11,14593.220000000001,7,7,10,24,Loyal Customers,2
446,53,8,10683.11,5,6,10,21,Loyal Customers,3
447,1,5,6275.04,10,3,6,19,Potential Loyalist,0
448,189,4,4424.38,1,2,4,7,Lost Customers,1
449,134,6,6240.950000000001,2,4,6,12,At Risk,3
450,83,3,3813.9700000000003,3,1,3,7,Lost Customers,1
451,67,6,5925.52,4,4,6,14,At Risk,3
452,25,5,3872.4300000000003,7,3,3,13,At Risk,0
453,42,8,6220.21,6,6,6,18,Potential Loyalist,3
454,50,7,9662.82,5,5,9,19,Potential Loyalist,3
455,68,3,4076.17,4,1,3,8,Lost Customers,1
456,89,5,6261.639999999999,3,3,6,12,At Risk,3
457,116,5,6553.5199999999995,2,3,7,12,At Risk,3
458,27,5,3615.63,7,3,2,12,At Risk,0
459,39,5,6449.13,6,3,6,15,Potential Loyalist,0
460,77,3,3597.96,4,1,2,7,Lost Customers,1
461,21,8,10366.86,8,6,10,24,Loyal Customers,2
462,143,6,7830.79,2,4,8,14,At Risk,3
463,68,6,6617.91,4,4,7,15,Potential Loyalist,3
464,10,6,8289.86,9,4,8,21,Loyal Customers,2
465,5,6,4766.91,10,4,4,18,Potential Loyalist,0
466,41,7,6597.52,6,5,7,18,Potential Loyalist,3
467,170,6,7065.389999999999,1,4,7,12,At Risk,3
468,95,6,7264.86,3,4,7,14,At Risk,3
469,102,10,7566.66,3,7,8,18,Potential Loyalist,3
470,10,7,7158.48,9,5,7,21,Loyal Customers,2
471,49,6,6243.62,5,4,6,15,Potential Loyalist,3
472,50,5,5989.66,5,3,6,14,At Risk,3
473,116,9,12033.62,2,6,10,18,Potential Loyalist,3
474,98,2,2107.8199999999997,3,1,1,5,Lost Customers,1
475,25,7,5131.25,7,5,5,17,Potential Loyalist,0
476,10,4,4416.9,9,2,4,15,Potential Loyalist,0
477,36,5,5899.43,6,3,6,15,Potential Loyalist,0
478,4,9,8880.93,10,6,9,25,Best Customers,2
479,77,9,8781.24,4,6,9,19,Potential Loyalist,3
480,18,2,3179.31,8,1,2,11,At Risk,0
481,15,2,2156.44,9,1,1,11,At Risk,0
482,76,10,11870.130000000001,4,7,10,21,Loyal Customers,3
483,41,7,8372.11,6,5,8,19,Potential Loyalist,2
484,20,4,5277.37,8,2,5,15,Potential Loyalist,0
485,15,6,5662.3099999999995,9,4,5,18,Potential Loyalist,0
486,92,5,7323.58,3,3,7,13,At Risk,3
487,140,2,1875.15,2,1,1,4,Lost Customers,1
488,28,6,4216.79,7,4,3,14,At Risk,0
489,125,5,5450.6900000000005,2,3,5,10,At Risk,1
490,54,9,9886.75,5,6,9,20,Loyal Customers,3
491,69,7,6140.67,4,5,6,15,Potential Loyalist,3
492,90,4,5248.15,3,2,5,10,At Risk,1
493,76,3,607.78,4,1,1,6,Lost Customers,1
494,134,2,2288.8999999999996,2,1,1,4,Lost Customers,1
495,129,6,6120.139999999999,2,4,6,12,At Risk,3
496,46,4,3612.19,6,2,2,10,At Risk,0
497,60,4,2772.15,5,2,2,9,Lost Customers,1
498,8,7,9834.95,10,5,9,24,Loyal Customers,2
499,56,11,8960.43,5,7,9,21,Loyal Customers,3
500,25,8,9381.92,7,6,9,22,Loyal Customers,2
501,183,3,2476.2,1,1,1,3,Lost Customers,1
502,167,4,3572.03,1,2,2,5,Lost Customers,1
503,84,3,2643.58,3,1,2,6,Lost Customers,1
504,137,8,7145.67,2,6,7,15,Potential Loyalist,3
505,15,5,6456.41,9,3,6,18,Potential Loyalist,0
506,57,10,14208.25,5,7,10,22,Loyal Customers,2
507,37,7,7567.66,6,5,8,19,Potential Loyalist,2
508,156,4,5351.73,1,2,5,8,Lost Customers,1
509,90,6,6017.45,3,4,6,13,At Risk,3
510,60,2,3333.38,5,1,2,8,Lost Customers,1
511,12,4,2708.2999999999997,9,2,2,13,At Risk,0
512,96,4,4233.95,3,2,3,8,Lost Customers,1
513,15,5,5958.04,9,3,6,18,Potential Loyalist,0
514,124,5,7401.06,2,3,7,12,At Risk,3
515,15,8,11033.65,9,6,10,25,Best Customers,2
516,20,10,9021.7,8,7,9,24,Loyal Customers,2
517,11,6,5083.11,9,4,4,17,Potential Loyalist,0
518,262,3,3288.99,1,1,2,4,Lost Customers,1
519,56,4,4470.85,5,2,4,11,At Risk,1
520,17,5,2566.04,8,3,1,12,At Risk,0
521,155,2,1849.5700000000002,1,1,1,3,Lost Customers,1
522,42,4,3520.19,6,2,2,10,At Risk,0
523,19,6,6485.21,8,4,6,18,Potential Loyalist,0
524,139,7,6400.86,2,5,6,13,At Risk,3
525,120,8,10372.68,2,6,10,18,Potential Loyalist,3
526,155,3,2674.66,1,1,2,4,Lost Customers,1
527,44,2,2476.84,6,1,1,8,Lost Customers,0
528,135,6,7636.76,2,4,8,14,At Risk,3
529,13,6,6036.22,9,4,6,19,Potential Loyalist,0
530,163,3,2816.79,1,1,2,4,Lost Customers,1
531,62,5,4164.33,4,3,3,10,At Risk,1
532,29,5,5725.47,7,3,5,15,Potential Loyalist,0
533,3,6,8210.1,10,4,8,22,Loyal Customers,2
534,7,8,8223.81,10,6,8,24,Loyal Customers,2
535,74,2,1679.29,4,1,1,6,Lost Customers,1
536,33,3,3876.23,7,1,3,11,At Risk,0
537,50,3,2906.29,5,1,2,8,Lost Customers,1
538,5,6,7716.14,10,4,8,22,Loyal Customers,2
539,37,8,7188.39,6,6,7,19,Potential Loyalist,2
540,80,6,4419.63,3,4,4,11,At Risk,1
541,138,5,6244.03,2,3,6,11,At Risk,3
542,39,6,6399.45,6,4,6,16,Potential Loyalist,3
543,1,5,4605.8,10,3,4,17,Potential Loyalist,0
544,174,4,4228.66,1,2,3,6,Lost Customers,1
545,7,6,8697.36,10,4,9,23,Loyal Customers,2
546,38,5,7164.9,6,3,7,16,Potential Loyalist,3
547,75,6,5913.53,4,4,6,14,At Risk,3
548,11,7,7497.25,9,5,8,22,Loyal Customers,2
549,41,8,7971.78,6,6,8,20,Loyal Customers,2
550,15,5,4546.57,9,3,4,16,Potential Loyalist,0
551,153,4,3722.38,1,2,3,6,Lost Customers,1
552,160,4,2960.2700000000004,1,2,2,5,Lost Customers,1
553,20,6,6913.18,8,4,7,19,Potential Loyalist,2
554,39,3,2306.3799999999997,6,1,1,8,Lost Customers,0
555,166,4,5261.73,1,2,5,8,Lost Customers,1
556,10,5,6960.33,9,3,7,19,Potential Loyalist,2
557,182,2,1834.45,1,1,1,3,Lost Customers,1
558,36,6,5672.88,6,4,5,15,Potential Loyalist,0
559,7,4,4129.68,10,2,3,15,Potential Loyalist,0
560,42,6,7033.26,6,4,7,17,Potential Loyalist,3
561,29,6,5776.22,7,4,5,16,Potential Loyalist,0
562,37,5,3686.94,6,3,3,12,At Risk,0
563,34,7,5492.75,7,5,5,17,Potential Loyalist,0
564,12,6,7415.54,9,4,7,20,Loyal Customers,2
565,105,10,12454.34,2,7,10,19,Potential Loyalist,3
566,53,3,2893.23,5,1,2,8,Lost Customers,1
567,61,4,1621.62,5,2,1,8,Lost Customers,1
568,92,7,5025.95,3,5,4,12,At Risk,3
569,99,4,7560.33,3,2,8,13,At Risk,3
570,36,6,6987.99,6,4,7,17,Potential Loyalist,3
571,73,3,3718.5299999999997,4,1,3,8,Lost Customers,1
572,14,6,5372.65,9,4,5,18,Potential Loyalist,0
573,106,2,2449.81,2,1,1,4,Lost Customers,1
574,278,4,4757.79,1,2,4,7,Lost Customers,1
575,249,2,1998.31,1,1,1,3,Lost Customers,1
576,8,6,9475.42,10,4,9,23,Loyal Customers,2
577,3,11,10515.0,10,7,10,27,Best Customers,2
578,200,7,6301.1,1,5,6,12,At Risk,3
579,53,9,10450.34,5,6,10,21,Loyal Customers,3
580,25,5,4456.28,7,3,4,14,At Risk,0
581,54,4,5597.1900000000005,5,2,5,12,At Risk,0
582,150,4,4163.0599999999995,1,2,3,6,Lost Customers,1
583,32,4,4129.98,7,2,3,12,At Risk,0
584,133,4,3399.5199999999995,2,2,2,6,Lost Customers,1
585,98,6,6998.68,3,4,7,14,At Risk,3
586,91,3,4165.02,3,1,3,7,Lost Customers,1
587,54,6,6833.56,5,4,7,16,Potential Loyalist,3
588,20,5,6053.33,8,3,6,17,Potential Loyalist,0
589,11,3,3259.93,9,1,2,12,At Risk,0
590,44,11,13200.69,6,7,10,23,Loyal Customers,2
591,222,2,1083.8,1,1,1,3,Lost Customers,1
592,200,4,3192.94,1,2,2,5,Lost Customers,1
593,2,6,5682.77,10,4,5,19,Potential Loyalist,0
594,34,9,11996.12,7,6,10,23,Loyal Customers,2
595,185,3,3268.42,1,1,2,4,Lost Customers,1
596,86,3,4864.71,3,1,4,8,Lost Customers,1
597,62,5,4299.400000000001,4,3,3,10,At Risk,1
598,132,7,5976.1900000000005,2,5,6,13,At Risk,3
599,116,5,7250.75,2,3,7,12,At Risk,3
600,207,3,3893.54,1,1,3,5,Lost Customers,1
601,59,5,5216.139999999999,5,3,5,13,At Risk,3
602,78,5,5591.28,4,3,5,12,At Risk,3
603,50,7,8284.07,5,5,8,18,Potential Loyalist,3
604,70,6,8162.76,4,4,8,16,Potential Loyalist,3
605,3,8,9180.130000000001,10,6,9,25,Best Customers,2
606,56,6,6229.09,5,4,6,15,Potential Loyalist,3
607,59,9,11867.92,5,6,10,21,Loyal Customers,3
608,86,8,9260.29,3,6,9,18,Potential Loyalist,3
609,37,4,3937.44,6,2,3,11,At Risk,0
610,47,9,8135.95,5,6,8,19,Potential Loyalist,3
611,4,8,10622.380000000001,10,6,10,26,Best Customers,2
612,88,3,2927.5299999999997,3,1,2,6,Lost Customers,1
613,4,6,5898.85,10,4,6,20,Loyal Customers,0
614,19,9,8557.0,8,6,9,23,Loyal Customers,2
615,43,4,6230.81,6,2,6,14,At Risk,0
616,93,4,5439.8099999999995,3,2,5,10,At Risk,1
617,21,4,3343.8599999999997,8,2,2,12,At Risk,0
618,309,2,2207.71,1,1,1,3,Lost Customers,1
619,66,7,7042.71,4,5,7,16,Potential Loyalist,3
620,104,8,5422.25,2,6,5,13,At Risk,3
621,3,9,11872.470000000001,10,6,10,26,Best Customers,2
622,267,3,4498.0,1,1,4,6,Lost Customers,1
623,94,3,5060.18,3,1,4,8,Lost Customers,1
624,91,3,5079.93,3,1,4,8,Lost Customers,1
625,17,6,5688.67,8,4,5,17,Potential Loyalist,0
626,55,9,8102.299999999999,5,6,8,19,Potential Loyalist,3
627,59,5,6786.53,5,3,7,15,Potential Loyalist,3
628,55,5,5519.54,5,3,5,13,At Risk,3
629,65,8,6490.53,4,6,6,16,Potential Loyalist,3
630,54,7,9406.55,5,5,9,19,Potential Loyalist,3
631,17,6,3211.98,8,4,2,14,At Risk,0
632,42,3,3911.85,6,1,3,10,At Risk,0
633,2,7,7054.02,10,5,7,22,Loyal Customers,2
634,18,7,6314.139999999999,8,5,6,19,Potential Loyalist,2
635,40,6,3988.82,6,4,3,13,At Risk,0
636,20,7,7808.71,8,5,8,21,Loyal Customers,2
637,8,13,13899.73,10,7,10,27,Best Customers,2
638,61,8,10198.93,5,6,10,21,Loyal Customers,3
639,9,6,5831.55,9,4,6,19,Potential Loyalist,0
640,11,8,11141.29,9,6,10,25,Best Customers,2
641,203,4,3853.34,1,2,3,6,Lost Customers,1
642,25,7,5304.37,7,5,5,17,Potential Loyalist,0
643,198,4,5034.78,1,2,4,7,Lost Customers,1
644,158,3,1808.74,1,1,1,3,Lost Customers,1
645,117,7,9008.59,2,5,9,16,Potential Loyalist,3
646,111,4,4809.5199999999995,2,2,4,8,Lost Customers,1
647,43,9,10703.609999999999,6,6,10,22,Loyal Customers,2
648,58,7,8410.93,5,5,8,18,Potential Loyalist,3
649,12,5,1718.19,9,3,1,13,At Risk,0
650,51,6,7082.77,5,4,7,16,Potential Loyalist,3
651,19,3,5028.17,8,1,4,13,At Risk,0
652,6,9,10240.87,10,6,10,26,Best Customers,2
653,38,5,4502.58,6,3,4,13,At Risk,0
654,29,3,3391.62,7,1,2,10,At Risk,0
655,52,6,8876.49,5,4,9,18,Potential Loyalist,3
656,11,8,8438.35,9,6,8,23,Loyal Customers,2
657,176,5,4830.48,1,3,4,8,Lost Customers,1
658,98,5,5305.31,3,3,5,11,At Risk,3
659,147,3,5140.610000000001,2,1,5,8,Lost Customers,1
660,13,4,5360.139999999999,9,2,5,16,Potential Loyalist,0
661,35,6,5564.07,6,4,5,15,Potential Loyalist,0
662,87,7,6635.87,3,5,7,15,Potential Loyalist,3
663,74,4,5447.21,4,2,5,11,At Risk,1
664,85,4,2941.31,3,2,2,7,Lost Customers,1
665,86,7,7378.3,3,5,7,15,Potential Loyalist,3
666,42,5,5173.84,6,3,5,14,At Risk,0
667,20,5,5826.33,8,3,5,16,Potential Loyalist,0
668,7,7,7399.77,10,5,7,22,Loyal Customers,2
669,9,11,12187.939999999999,9,7,10,26,Best Customers,2
670,117,4,4078.4,2,2,3,7,Lost Customers,1
671,63,6,7450.68,4,4,8,16,Potential Loyalist,3
672,51,3,4786.22,5,1,4,10,At Risk,1
673,3,5,3435.2200000000003,10,3,2,15,Potential Loyalist,0
674,116,6,6404.85,2,4,6,12,At Risk,3
675,1,3,4204.51,10,1,3,14,At Risk,0
676,34,6,6739.82,7,4,7,18,Potential Loyalist,2
677,72,5,3703.87,4,3,3,10,At Risk,1
678,95,3,2079.27,3,1,1,5,Lost Customers,1
679,63,10,8300.07,4,7,8,19,Potential Loyalist,3
680,15,4,5597.05,9,2,5,16,Potential Loyalist,0
681,8,6,5888.74,10,4,6,20,Loyal Customers,0
682,21,7,8280.35,8,5,8,21,Loyal Customers,2
683,16,5,5616.71,8,3,5,16,Potential Loyalist,0
684,43,8,6011.92,6,6,6,18,Potential Loyalist,3
685,103,6,9271.630000000001,3,4,9,16,Potential Loyalist,3
686,38,5,4622.87,6,3,4,13,At Risk,0
687,9,6,2828.68,9,4,2,15,Potential Loyalist,0
688,82,4,5647.04,3,2,5,10,At Risk,1
689,13,3,3614.25,9,1,2,12,At Risk,0
690,65,5,4511.08,4,3,4,11,At Risk,1
691,40,8,9841.22,6,6,9,21,Loyal Customers,2
692,51,9,8189.47,5,6,8,19,Potential Loyalist,3
693,11,5,6667.92,9,3,7,19,Potential Loyalist,2
694,8,5,4359.78,10,3,3,16,Potential Loyalist,0
695,17,8,10407.64,8,6,10,24,Loyal Customers,2
696,22,6,3720.1,8,4,3,15,Potential Loyalist,0
697,12,4,5888.76,9,2,6,17,Potential Loyalist,0
698,77,3,3362.66,4,1,2,7,Lost Customers,1
699,56,3,2655.81,5,1,2,8,Lost Customers,1
700,107,8,7960.03,2,6,8,16,Potential Loyalist,3
701,33,6,6285.29,7,4,6,17,Potential Loyalist,0
702,63,3,3825.6600000000003,4,1,3,8,Lost Customers,1
703,2,5,7301.150000000001,10,3,7,20,Loyal Customers,2
704,11,10,10881.81,9,7,10,26,Best Customers,2
705,12,4,2127.86,9,2,1,12,At Risk,0
706,31,6,10040.5,7,4,9,20,Loyal Customers,2
707,45,6,7563.61,6,4,8,18,Potential Loyalist,3
708,176,3,3149.0299999999997,1,1,2,4,Lost Customers,1
709,147,5,5948.8099999999995,2,3,6,11,At Risk,3
710,40,6,7830.88,6,4,8,18,Potential Loyalist,3
711,84,4,3784.83,3,2,3,8,Lost Customers,1
712,62,8,9223.66,4,6,9,19,Potential Loyalist,3
713,256,4,4564.42,1,2,4,7,Lost Customers,1
714,60,8,6904.01,5,6,7,18,Potential Loyalist,3
715,159,3,4278.66,1,1,3,5,Lost Customers,1
716,13,6,6680.78,9,4,7,20,Loyal Customers,2
717,15,6,4696.91,9,4,4,17,Potential Loyalist,0
718,35,8,6777.43,6,6,7,19,Potential Loyalist,2
719,12,7,9485.32,9,5,9,23,Loyal Customers,2
720,21,10,13004.35,8,7,10,25,Best Customers,2
721,5,7,8883.609999999999,10,5,9,24,Loyal Customers,2
722,88,5,6548.61,3,3,6,12,At Risk,3
723,16,8,7012.59,8,6,7,21,Loyal Customers,2
724,24,8,9812.699999999999,8,6,9,23,Loyal Customers,2
725,4,11,13048.82,10,7,10,27,Best Customers,2
726,55,3,5134.71,5,1,5,11,At Risk,0
727,62,6,8768.09,4,4,9,17,Potential Loyalist,3
728,26,9,10919.45,7,6,10,23,Loyal Customers,2
729,2,9,14032.57,10,6,10,26,Best Customers,2
730,15,7,6529.49,9,5,6,20,Loyal Customers,2
731,135,4,3872.51,2,2,3,7,Lost Customers,1
732,65,5,6099.150000000001,4,3,6,13,At Risk,3
733,47,10,14532.51,5,7,10,22,Loyal Customers,2
734,90,3,3346.12,3,1,2,6,Lost Customers,1
735,88,4,6814.03,3,2,7,12,At Risk,3
736,12,5,5823.83,9,3,5,17,Potential Loyalist,0
737,55,7,7386.14,5,5,7,17,Potential Loyalist,3
738,70,8,8764.37,4,6,9,19,Potential Loyalist,3
739,2,10,9430.63,10,7,9,26,Best Customers,2
740,62,4,6155.53,4,2,6,12,At Risk,3
741,149,5,3482.3,1,3,2,6,Lost Customers,1
742,11,6,6918.96,9,4,7,20,Loyal Customers,2
743,90,4,4994.21,3,2,4,9,Lost Customers,1
744,24,5,4149.55,8,3,3,14,At Risk,0
745,12,4,2697.98,9,2,2,13,At Risk,0
746,44,6,4853.96,6,4,4,14,At Risk,0
747,36,2,1801.98,6,1,1,8,Lost Customers,0
748,47,9,8538.05,5,6,9,20,Loyal Customers,3
749,81,9,7591.94,3,6,8,17,Potential Loyalist,3
750,59,6,7506.73,5,4,8,17,Potential Loyalist,3
751,131,2,386.48,2,1,1,4,Lost Customers,1
752,21,8,8004.32,8,6,8,22,Loyal Customers,2
753,16,8,11935.380000000001,8,6,10,24,Loyal Customers,2
754,211,2,814.03,1,1,1,3,Lost Customers,1
755,96,3,2071.7799999999997,3,1,1,5,Lost Customers,1
756,26,6,3859.17,7,4,3,14,At Risk,0
757,73,5,3967.6,4,3,3,10,At Risk,1
758,28,2,651.02,7,1,1,9,Lost Customers,0
759,24,8,7442.61,8,6,7,21,Loyal Customers,2
760,27,9,8569.289999999999,7,6,9,22,Loyal Customers,2
761,146,5,6483.68,2,3,6,11,At Risk,3
762,86,5,3989.6800000000003,3,3,3,9,Lost Customers,1
763,75,6,6989.88,4,4,7,15,Potential Loyalist,3
764,80,3,3627.46,3,1,2,6,Lost Customers,1
765,25,10,8794.98,7,7,9,23,Loyal Customers,2
766,17,6,4962.24,8,4,4,16,Potential Loyalist,0
767,43,5,6197.59,6,3,6,15,Potential Loyalist,0
768,6,9,9425.52,10,6,9,25,Best Customers,2
769,20,8,9694.79,8,6,9,23,Loyal Customers,2
770,50,6,6789.790000000001,5,4,7,16,Potential Loyalist,3
771,125,6,5901.7,2,4,6,12,At Risk,3
772,3,5,6628.15,10,3,7,20,Loyal Customers,2
773,73,8,10334.68,4,6,10,20,Loyal Customers,3
774,144,1,1311.44,2,1,1,4,Lost Customers,1
775,59,7,6985.21,5,5,7,17,Potential Loyalist,3
776,14,9,9151.17,9,6,9,24,Loyal Customers,2
777,28,6,5113.99,7,4,5,16,Potential Loyalist,0
778,264,3,2604.18,1,1,2,4,Lost Customers,1
779,83,4,3079.5,3,2,2,7,Lost Customers,1
780,89,3,3499.7200000000003,3,1,2,6,Lost Customers,1
781,126,5,3763.4600000000005,2,3,3,8,Lost Customers,1
782,26,5,8440.67,7,3,8,18,Potential Loyalist,2
783,97,5,6170.6,3,3,6,12,At Risk,3
784,144,2,760.18,2,1,1,4,Lost Customers,1
785,19,5,2941.55,8,3,2,13,At Risk,0
786,10,7,7114.27,9,5,7,21,Loyal Customers,2
787,76,10,11292.54,4,7,10,21,Loyal Customers,3
788,40,5,4638.62,6,3,4,13,At Risk,0
789,5,8,4497.3,10,6,4,20,Loyal Customers,0
790,15,8,9306.61,9,6,9,24,Loyal Customers,2
791,124,6,6605.22,2,4,7,13,At Risk,3
792,18,6,6907.9,8,4,7,19,Potential Loyalist,2
793,2,10,12116.11,10,7,10,27,Best Customers,2
794,23,7,7832.74,8,5,8,21,Loyal Customers,2
795,19,5,5980.89,8,3,6,17,Potential Loyalist,0
796,7,7,6097.05,10,5,6,21,Loyal Customers,2
797,22,4,4668.49,8,2,4,14,At Risk,0
798,22,3,4285.05,8,1,3,12,At Risk,0
799,11,11,14399.89,9,7,10,26,Best Customers,2
800,86,6,6283.9,3,4,6,13,At Risk,3
801,183,2,1074.8,1,1,1,3,Lost Customers,1
802,96,6,7508.74,3,4,8,15,Potential Loyalist,3
803,67,6,3818.25,4,4,3,11,At Risk,1
804,42,3,3480.5,6,1,2,9,Lost Customers,0
805,123,6,6966.17,2,4,7,13,At Risk,3
806,32,4,4854.46,7,2,4,13,At Risk,0
807,81,4,4367.13,3,2,3,8,Lost Customers,1
808,124,3,3676.8199999999997,2,1,3,6,Lost Customers,1
809,46,4,3653.47,6,2,3,11,At Risk,0
810,69,4,4539.42,4,2,4,10,At Risk,1
811,175,3,1388.03,1,1,1,3,Lost Customers,1
812,198,2,1400.23,1,1,1,3,Lost Customers,1
813,51,5,4386.05,5,3,3,11,At Risk,1
814,49,3,4661.23,5,1,4,10,At Risk,1
815,28,6,7646.77,7,4,8,19,Potential Loyalist,2
816,54,3,1548.1299999999999,5,1,1,7,Lost Customers,1
817,17,5,5340.0,8,3,5,16,Potential Loyalist,0
818,41,6,6141.46,6,4,6,16,Potential Loyalist,3
819,44,5,5033.21,6,3,4,13,At Risk,0
820,4,9,7355.73,10,6,7,23,Loyal Customers,2
821,34,5,4826.39,7,3,4,14,At Risk,0
822,329,1,2005.66,1,1,1,3,Lost Customers,1
823,24,6,9755.81,8,4,9,21,Loyal Customers,2
824,10,4,6017.27,9,2,6,17,Potential Loyalist,0
825,11,6,4476.59,9,4,4,17,Potential Loyalist,0
826,5,4,4829.57,10,2,4,16,Potential Loyalist,0
827,50,8,9051.45,5,6,9,20,Loyal Customers,3
828,80,5,3777.5299999999997,3,3,3,9,Lost Customers,1
829,13,6,9236.19,9,4,9,22,Loyal Customers,2
830,150,6,6106.9400000000005,1,4,6,11,At Risk,3
831,12,5,4245.84,9,3,3,15,Potential Loyalist,0
832,18,11,12410.17,8,7,10,25,Best Customers,2
833,26,8,8852.31,7,6,9,22,Loyal Customers,2
834,19,4,3595.5299999999997,8,2,2,12,At Risk,0
835,8,8,8541.23,10,6,9,25,Best Customers,2
836,73,4,3562.2,4,2,2,8,Lost Customers,1
837,158,3,3406.25,1,1,2,4,Lost Customers,1
838,42,4,3724.8199999999997,6,2,3,11,At Risk,0
839,107,4,2550.73,2,2,1,5,Lost Customers,1
840,39,6,8144.96,6,4,8,18,Potential Loyalist,3
841,151,7,10936.2,1,5,10,16,Potential Loyalist,3
842,56,3,2614.8,5,1,2,8,Lost Customers,1
843,3,6,4090.19,10,4,3,17,Potential Loyalist,0
844,32,9,12523.55,7,6,10,23,Loyal Customers,2
845,126,3,2004.13,2,1,1,4,Lost Customers,1
846,83,3,4385.62,3,1,3,7,Lost Customers,1
847,115,4,4928.17,2,2,4,8,Lost Customers,1
848,141,4,4711.04,2,2,4,8,Lost Customers,1
849,28,6,6086.66,7,4,6,17,Potential Loyalist,0
850,35,8,7476.79,6,6,8,20,Loyal Customers,2
851,10,4,5347.0,9,2,5,16,Potential Loyalist,0
853,65,9,12711.369999999999,4,6,10,20,Loyal Customers,3
854,9,4,3992.51,9,2,3,14,At Risk,0
855,105,4,7241.66,2,2,7,11,At Risk,3
856,2,7,6845.04,10,5,7,22,Loyal Customers,2
857,25,5,6692.93,7,3,7,17,Potential Loyalist,2
858,12,6,5654.55,9,4,5,18,Potential Loyalist,0
859,19,6,6979.780000000001,8,4,7,19,Potential Loyalist,2
860,92,4,7381.19,3,2,7,12,At Risk,3
861,55,5,5226.41,5,3,5,13,At Risk,3
862,55,1,774.53,5,1,1,7,Lost Customers,1
863,70,4,2288.23,4,2,1,7,Lost Customers,1
864,47,6,8911.39,5,4,9,18,Potential Loyalist,3
865,122,7,7192.900000000001,2,5,7,14,At Risk,3
866,99,5,7599.92,3,3,8,14,At Risk,3
867,294,5,6543.92,1,3,6,10,At Risk,3
868,84,6,7529.639999999999,3,4,8,15,Potential Loyalist,3
870,101,7,6201.42,3,5,6,14,At Risk,3
871,55,8,8700.560000000001,5,6,9,20,Loyal Customers,3
872,172,1,290.62,1,1,1,3,Lost Customers,1
873,32,5,4426.2,7,3,4,14,At Risk,0
874,47,8,8569.99,5,6,9,20,Loyal Customers,3
875,64,6,6933.69,4,4,7,15,Potential Loyalist,3
876,17,3,2732.4700000000003,8,1,2,11,At Risk,0
877,18,9,9182.89,8,6,9,23,Loyal Customers,2
878,80,3,4531.79,3,1,4,8,Lost Customers,1
879,77,4,3356.34,4,2,2,8,Lost Customers,1
880,63,3,4774.51,4,1,4,9,Lost Customers,1
881,148,3,5353.86,1,1,5,7,Lost Customers,1
882,113,5,6628.360000000001,2,3,7,12,At Risk,3
883,48,4,2114.02,5,2,1,8,Lost Customers,1
884,2,5,9210.74,10,3,9,22,Loyal Customers,2
885,8,3,3628.9399999999996,10,1,2,13,At Risk,0
886,2,7,9025.03,10,5,9,24,Loyal Customers,2
887,40,8,10938.66,6,6,10,22,Loyal Customers,2
888,69,5,5750.62,4,3,5,12,At Risk,3
889,37,5,4366.950000000001,6,3,3,12,At Risk,0
890,166,4,4485.6,1,2,4,7,Lost Customers,1
891,13,4,4632.05,9,2,4,15,Potential Loyalist,0
892,91,10,9618.64,3,7,9,19,Potential Loyalist,3
893,76,7,9202.85,4,5,9,18,Potential Loyalist,3
894,49,8,7512.48,5,6,8,19,Potential Loyalist,3
895,62,3,2714.21,4,1,2,7,Lost Customers,1
896,39,4,4448.32,6,2,4,12,At Risk,0
897,130,6,7311.98,2,4,7,13,At Risk,3
898,206,1,478.16,1,1,1,3,Lost Customers,1
899,50,6,4240.0599999999995,5,4,3,12,At Risk,0
900,13,4,2446.44,9,2,1,12,At Risk,0
901,83,4,6948.22,3,2,7,12,At Risk,3
902,15,9,9408.53,9,6,9,24,Loyal Customers,2
903,17,9,10102.58,8,6,10,24,Loyal Customers,2
904,38,4,5063.82,6,2,4,12,At Risk,0
905,106,8,6801.49,2,6,7,15,Potential Loyalist,3
906,17,9,12920.289999999999,8,6,10,24,Loyal Customers,2
907,27,7,3448.87,7,5,2,14,At Risk,0
908,5,7,4679.15,10,5,4,19,Potential Loyalist,0
909,190,5,8560.51,1,3,9,13,At Risk,3
910,273,2,1932.55,1,1,1,3,Lost Customers,1
911,57,5,3792.6,5,3,3,11,At Risk,1
912,41,7,7206.52,6,5,7,18,Potential Loyalist,3
913,114,3,3591.41,2,1,2,5,Lost Customers,1
914,107,5,5533.82,2,3,5,10,At Risk,1
915,29,4,3737.5699999999997,7,2,3,12,At Risk,0
916,37,4,4884.0,6,2,4,12,At Risk,0
917,36,8,7452.88,6,6,8,20,Loyal Customers,2
918,17,5,5684.7,8,3,5,16,Potential Loyalist,0
919,81,9,10701.04,3,6,10,19,Potential Loyalist,3
920,91,6,6259.75,3,4,6,13,At Risk,3
921,45,7,10039.39,6,5,9,20,Loyal Customers,2
922,189,1,569.56,1,1,1,3,Lost Customers,1
923,33,7,6019.1900000000005,7,5,6,18,Potential Loyalist,2
924,110,8,7663.97,2,6,8,16,Potential Loyalist,3
925,13,9,10701.39,9,6,10,25,Best Customers,2
926,13,5,4212.57,9,3,3,15,Potential Loyalist,0
927,296,3,3712.1099999999997,1,1,3,5,Lost Customers,1
928,12,8,6370.69,9,6,6,21,Loyal Customers,2
929,57,5,4985.79,5,3,4,12,At Risk,0
930,148,2,1431.17,1,1,1,3,Lost Customers,1
931,71,5,6046.89,4,3,6,13,At Risk,3
932,4,6,4854.48,10,4,4,18,Potential Loyalist,0
933,1,5,7598.65,10,3,8,21,Loyal Customers,2
934,1,7,8420.86,10,5,8,23,Loyal Customers,2
935,54,7,8652.22,5,5,9,19,Potential Loyalist,3
936,33,11,15702.07,7,7,10,24,Loyal Customers,2
937,16,5,4550.33,8,3,4,15,Potential Loyalist,0
938,62,8,7614.88,4,6,8,18,Potential Loyalist,3
939,32,4,5121.02,7,2,5,14,At Risk,0
940,53,5,6172.42,5,3,6,14,At Risk,3
941,34,10,17898.46,7,7,10,24,Loyal Customers,2
942,214,2,2265.36,1,1,1,3,Lost Customers,1
943,113,6,7886.52,2,4,8,14,At Risk,3
944,134,7,4739.16,2,5,4,11,At Risk,1
945,15,7,9247.25,9,5,9,23,Loyal Customers,2
946,3,8,10866.75,10,6,10,26,Best Customers,2
947,81,5,5493.35,3,3,5,11,At Risk,3
948,101,3,3541.6,3,1,2,6,Lost Customers,1
949,89,6,6945.2699999999995,3,4,7,14,At Risk,3
950,33,7,8329.7,7,5,8,20,Loyal Customers,2
951,7,6,4934.83,10,4,4,18,Potential Loyalist,0
952,47,5,6239.17,5,3,6,14,At Risk,3
953,12,9,10996.0,9,6,10,25,Best Customers,2
954,114,4,5686.3099999999995,2,2,5,9,Lost Customers,1
955,14,7,3915.94,9,5,3,17,Potential Loyalist,0
956,174,3,3675.74,1,1,3,5,Lost Customers,1
957,39,5,4868.3,6,3,4,13,At Risk,0
958,35,6,5470.129999999999,6,4,5,15,Potential Loyalist,0
959,77,6,5701.85,4,4,5,13,At Risk,3
960,79,4,5971.35,3,2,6,11,At Risk,3
961,65,3,3792.14,4,1,3,8,Lost Customers,1
962,3,7,5930.2699999999995,10,5,6,21,Loyal Customers,2
963,61,12,12068.12,5,7,10,22,Loyal Customers,2
964,2,5,4224.59,10,3,3,16,Potential Loyalist,0
965,61,4,5232.65,5,2,5,12,At Risk,0
966,14,4,1885.61,9,2,1,12,At Risk,0
967,67,4,5974.77,4,2,6,12,At Risk,3
968,36,6,7331.34,6,4,7,17,Potential Loyalist,3
969,18,5,6968.38,8,3,7,18,Potential Loyalist,2
970,34,5,6237.67,7,3,6,16,Potential Loyalist,0
971,49,5,5862.57,5,3,6,14,At Risk,3
972,176,2,3318.8099999999995,1,1,2,4,Lost Customers,1
973,9,8,12724.26,9,6,10,25,Best Customers,2
974,7,6,6929.71,10,4,7,21,Loyal Customers,2
975,11,8,9093.88,9,6,9,24,Loyal Customers,2
976,171,6,6710.5599999999995,1,4,7,12,At Risk,3
977,42,5,5149.34,6,3,5,14,At Risk,0
978,193,5,4373.97,1,3,3,7,Lost Customers,1
979,6,5,7486.82,10,3,8,21,Loyal Customers,2
980,178,4,5656.34,1,2,5,8,Lost Customers,1
981,26,7,9042.05,7,5,9,21,Loyal Customers,2
982,56,6,2794.7500000000005,5,4,2,11,At Risk,1
983,2,8,9637.26,10,6,9,25,Best Customers,2
984,57,8,6208.719999999999,5,6,6,17,Potential Loyalist,3
985,15,4,5554.1900000000005,9,2,5,16,Potential Loyalist,0
986,76,8,8673.32,4,6,9,19,Potential Loyalist,3
987,23,8,8979.65,8,6,9,23,Loyal Customers,2
988,113,2,769.14,2,1,1,4,Lost Customers,1
989,26,4,5497.84,7,2,5,14,At Risk,0
990,12,7,8441.6,9,5,8,22,Loyal Customers,2
991,148,6,7774.3,1,4,8,13,At Risk,3
992,204,1,1807.45,1,1,1,3,Lost Customers,1
993,1,9,8086.79,10,6,8,24,Loyal Customers,2
994,43,5,3901.01,6,3,3,12,At Risk,0
995,12,7,9379.039999999999,9,5,9,23,Loyal Customers,2
996,64,5,6754.42,4,3,7,14,At Risk,3
997,60,7,6397.73,5,5,6,16,Potential Loyalist,3
998,322,2,1565.5500000000002,1,1,1,3,Lost Customers,1
999,77,9,14166.42,4,6,10,20,Loyal Customers,3
1000,1,9,10183.7,10,6,10,26,Best Customers,2
1001,43,7,6233.51,6,5,6,17,Potential Loyalist,3
1002,156,4,5038.32,1,2,4,7,Lost Customers,1
1003,48,9,9111.19,5,6,9,20,Loyal Customers,3
1004,204,6,8437.87,1,4,8,13,At Risk,3
1005,160,5,7863.76,1,3,8,12,At Risk,3
1006,38,8,9481.25,6,6,9,21,Loyal Customers,2
1007,21,6,7998.95,8,4,8,20,Loyal Customers,2
1008,18,4,5409.6900000000005,8,2,5,15,Potential Loyalist,0
1009,55,4,5716.2,5,2,5,12,At Risk,0
1010,127,3,1501.59,2,1,1,4,Lost Customers,1
1011,243,3,3940.1800000000003,1,1,3,5,Lost Customers,1
1012,10,4,5094.62,9,2,5,16,Potential Loyalist,0
1013,96,6,7207.57,3,4,7,14,At Risk,3
1014,5,7,6269.75,10,5,6,21,Loyal Customers,2
1015,27,6,7096.79,7,4,7,18,Potential Loyalist,2
1016,67,6,5697.8,4,4,5,13,At Risk,3
1017,227,3,5234.68,1,1,5,7,Lost Customers,1
1018,27,5,6164.88,7,3,6,16,Potential Loyalist,0
1019,43,4,4653.39,6,2,4,12,At Risk,0
1020,90,4,4075.21,3,2,3,8,Lost Customers,1
1021,29,8,9624.45,7,6,9,22,Loyal Customers,2
1022,84,5,8161.4,3,3,8,14,At Risk,3
1023,126,2,1579.3899999999999,2,1,1,4,Lost Customers,1
1024,35,8,9592.029999999999,6,6,9,21,Loyal Customers,2
1025,61,8,8141.29,5,6,8,19,Potential Loyalist,3
1026,30,6,4769.8099999999995,7,4,4,15,Potential Loyalist,0
1027,25,6,6580.15,7,4,7,18,Potential Loyalist,2
1028,9,7,12001.41,9,5,10,24,Loyal Customers,2
1029,31,6,6223.08,7,4,6,17,Potential Loyalist,0
1030,40,8,10951.8,6,6,10,22,Loyal Customers,2
1031,47,2,1994.54,5,1,1,7,Lost Customers,1
1032,31,8,6902.84,7,6,7,20,Loyal Customers,2
1033,15,8,11261.67,9,6,10,25,Best Customers,2
1034,105,2,1819.46,2,1,1,4,Lost Customers,1
1035,14,3,1327.0600000000002,9,1,1,11,At Risk,0
1036,163,5,7125.26,1,3,7,11,At Risk,3
1037,74,7,6689.55,4,5,7,16,Potential Loyalist,3
1038,13,4,6144.11,9,2,6,17,Potential Loyalist,0
1039,53,7,9522.77,5,5,9,19,Potential Loyalist,3
1040,162,4,4072.65,1,2,3,6,Lost Customers,1
1041,21,4,4271.03,8,2,3,13,At Risk,0
1042,36,3,4585.77,6,1,4,11,At Risk,0
1043,171,7,9704.39,1,5,9,15,Potential Loyalist,3
1044,113,5,4616.29,2,3,4,9,Lost Customers,1
1045,114,3,4405.6,2,1,3,6,Lost Customers,1
1046,53,5,3846.1,5,3,3,11,At Risk,1
1047,58,7,5171.35,5,5,5,15,Potential Loyalist,3
1048,134,6,4864.99,2,4,4,10,At Risk,1
1049,33,10,11130.050000000001,7,7,10,24,Loyal Customers,2
1050,27,6,4722.12,7,4,4,15,Potential Loyalist,0
1051,180,5,4878.8099999999995,1,3,4,8,Lost Customers,1
1052,1,6,8478.41,10,4,8,22,Loyal Customers,2
1053,140,3,3482.79,2,1,2,5,Lost Customers,1
1054,6,8,8433.75,10,6,8,24,Loyal Customers,2
1055,207,2,924.06,1,1,1,3,Lost Customers,1
1056,25,7,7920.27,7,5,8,20,Loyal Customers,2
1057,113,3,4028.4700000000003,2,1,3,6,Lost Customers,1
1058,117,3,2308.7200000000003,2,1,1,4,Lost Customers,1
1059,23,2,2449.81,8,1,1,10,At Risk,0
1060,188,6,9606.77,1,4,9,14,At Risk,3
1061,25,6,4056.76,7,4,3,14,At Risk,0
1062,3,6,7619.47,10,4,8,22,Loyal Customers,2
1063,47,6,5833.22,5,4,6,15,Potential Loyalist,3
1064,140,3,5404.67,2,1,5,8,Lost Customers,1
1065,80,6,4709.66,3,4,4,11,At Risk,1
1066,167,3,2637.5299999999997,1,1,2,4,Lost Customers,1
1067,233,2,1854.93,1,1,1,3,Lost Customers,1
1068,5,14,14254.55,10,7,10,27,Best Customers,2
1069,205,5,6910.5,1,3,7,11,At Risk,3
1070,1,4,5754.66,10,2,5,17,Potential Loyalist,0
1071,40,6,7958.68,6,4,8,18,Potential Loyalist,3
1072,47,3,3697.58,5,1,3,9,Lost Customers,1
1073,18,6,6454.889999999999,8,4,6,18,Potential Loyalist,0
1074,17,8,9370.01,8,6,9,23,Loyal Customers,2
1075,68,6,6597.82,4,4,7,15,Potential Loyalist,3
1076,10,12,14390.1,9,7,10,26,Best Customers,2
1077,6,6,6570.4400000000005,10,4,7,21,Loyal Customers,2
1078,19,5,3640.2200000000003,8,3,3,14,At Risk,0
1079,18,4,3829.1099999999997,8,2,3,13,At Risk,0
1080,48,3,3133.43,5,1,2,8,Lost Customers,1
1081,12,5,6119.719999999999,9,3,6,18,Potential Loyalist,0
1082,48,5,4492.05,5,3,4,12,At Risk,0
1083,267,2,2418.19,1,1,1,3,Lost Customers,1
1084,5,10,11206.14,10,7,10,27,Best Customers,2
1085,65,4,2487.7000000000003,4,2,1,7,Lost Customers,1
1086,14,9,8640.220000000001,9,6,9,24,Loyal Customers,2
1087,15,3,3535.79,9,1,2,12,At Risk,0
1088,14,6,6230.39,9,4,6,19,Potential Loyalist,0
1089,152,7,6202.85,1,5,6,12,At Risk,3
1090,72,7,5882.43,4,5,6,15,Potential Loyalist,3
1091,5,10,10147.25,10,7,10,27,Best Customers,2
1092,203,5,4893.719999999999,1,3,4,8,Lost Customers,1
1093,100,9,12492.4,3,6,10,19,Potential Loyalist,3
1094,44,7,7255.12,6,5,7,18,Potential Loyalist,3
1095,15,4,6916.039999999999,9,2,7,18,Potential Loyalist,0
1096,56,5,3865.37,5,3,3,11,At Risk,1
1097,189,3,2378.5099999999998,1,1,1,3,Lost Customers,1
1098,9,8,7594.29,9,6,8,23,Loyal Customers,2
1099,111,2,1248.96,2,1,1,4,Lost Customers,1
1100,46,3,2767.35,6,1,2,9,Lost Customers,0
1101,114,5,6377.620000000001,2,3,6,11,At Risk,3
1102,22,8,8832.98,8,6,9,23,Loyal Customers,2
1103,33,12,15447.92,7,7,10,24,Loyal Customers,2
1104,12,7,6458.3,9,5,6,20,Loyal Customers,2
1105,17,2,3965.4399999999996,8,1,3,12,At Risk,0
1106,25,9,11078.470000000001,7,6,10,23,Loyal Customers,2
1107,49,5,3752.08,5,3,3,11,At Risk,1
1108,13,4,1790.0,9,2,1,12,At Risk,0
1109,209,3,2411.02,1,1,1,3,Lost Customers,1
1110,18,6,7310.36,8,4,7,19,Potential Loyalist,2
1111,21,7,6922.7,8,5,7,20,Loyal Customers,2
1112,109,3,3589.44,2,1,2,5,Lost Customers,1
1113,27,9,10999.37,7,6,10,23,Loyal Customers,2
1114,65,4,4156.4,4,2,3,9,Lost Customers,1
1115,3,9,9270.03,10,6,9,25,Best Customers,2
1116,8,3,4932.34,10,1,4,15,Potential Loyalist,0
1117,137,9,7547.219999999999,2,6,8,16,Potential Loyalist,3
1118,39,4,3365.19,6,2,2,10,At Risk,0
1119,99,6,10841.93,3,4,10,17,Potential Loyalist,3
1120,2,5,3916.82,10,3,3,16,Potential Loyalist,0
1121,8,2,2973.36,10,1,2,13,At Risk,0
1122,27,5,4714.81,7,3,4,14,At Risk,0
1123,11,5,6742.5,9,3,7,19,Potential Loyalist,2
1124,45,3,3731.08,6,1,3,10,At Risk,0
1125,30,5,3793.5699999999997,7,3,3,13,At Risk,0
1126,20,4,4725.4400000000005,8,2,4,14,At Risk,0
1127,137,4,5261.43,2,2,5,9,Lost Customers,1
1128,27,5,5855.4400000000005,7,3,6,16,Potential Loyalist,0
1129,27,13,18349.27,7,7,10,24,Loyal Customers,2
1130,118,5,6301.28,2,3,6,11,At Risk,3
1131,54,7,9150.94,5,5,9,19,Potential Loyalist,3
1132,45,8,9603.1,6,6,9,21,Loyal Customers,2
1133,76,5,7124.59,4,3,7,14,At Risk,3
1134,4,6,6297.860000000001,10,4,6,20,Loyal Customers,0
1135,165,3,3530.65,1,1,2,4,Lost Customers,1
1136,36,5,5369.95,6,3,5,14,At Risk,0
1137,6,9,8092.31,10,6,8,24,Loyal Customers,2
1138,125,6,7506.16,2,4,8,14,At Risk,3
1139,70,4,3684.36,4,2,3,9,Lost Customers,1
1140,7,11,12657.130000000001,10,7,10,27,Best Customers,2
1141,134,5,4507.79,2,3,4,9,Lost Customers,1
1142,39,4,4828.39,6,2,4,12,At Risk,0
1143,5,5,7112.88,10,3,7,20,Loyal Customers,2
1144,18,7,9425.65,8,5,9,22,Loyal Customers,2
1145,14,2,2382.7200000000003,9,1,1,11,At Risk,0
1146,74,2,2213.67,4,1,1,6,Lost Customers,1
1147,166,6,8766.869999999999,1,4,9,14,At Risk,3
1148,9,3,3426.09,9,1,2,12,At Risk,0
1149,189,4,5793.360000000001,1,2,5,8,Lost Customers,1
1150,104,5,8439.82,2,3,8,13,At Risk,3
1151,76,5,5819.58,4,3,5,12,At Risk,3
1152,25,8,9434.77,7,6,9,22,Loyal Customers,2
1153,18,5,3306.2400000000002,8,3,2,13,At Risk,0
1154,132,6,3442.7799999999997,2,4,2,8,Lost Customers,1
1155,30,7,5342.13,7,5,5,17,Potential Loyalist,0
1156,41,4,5965.4400000000005,6,2,6,14,At Risk,0
1157,86,7,7726.53,3,5,8,16,Potential Loyalist,3
1158,3,6,7962.85,10,4,8,22,Loyal Customers,2
1159,7,4,5803.34,10,2,5,17,Potential Loyalist,0
1160,164,3,3192.0099999999998,1,1,2,4,Lost Customers,1
1161,13,4,4151.98,9,2,3,14,At Risk,0
1162,137,4,5369.27,2,2,5,9,Lost Customers,1
1163,49,5,2853.67,5,3,2,10,At Risk,1
1164,154,3,2164.22,1,1,1,3,Lost Customers,1
1165,11,9,6796.88,9,6,7,22,Loyal Customers,2
1166,15,6,7638.8,9,4,8,21,Loyal Customers,2
1167,11,4,4106.64,9,2,3,14,At Risk,0
1168,60,7,10263.16,5,5,10,20,Loyal Customers,3
1169,63,7,7605.57,4,5,8,17,Potential Loyalist,3
1170,87,5,6345.1,3,3,6,12,At Risk,3
1171,35,9,9811.45,6,6,9,21,Loyal Customers,2
1172,45,5,6054.04,6,3,6,15,Potential Loyalist,0
1173,109,3,2042.9699999999998,2,1,1,4,Lost Customers,1
1174,9,3,3466.9300000000003,9,1,2,12,At Risk,0
1175,219,2,2449.24,1,1,1,3,Lost Customers,1
1176,78,4,3909.54,4,2,3,9,Lost Customers,1
1177,88,8,8367.47,3,6,8,17,Potential Loyalist,3
1178,45,8,10226.15,6,6,10,22,Loyal Customers,2
1179,8,4,6441.950000000001,10,2,6,18,Potential Loyalist,0
1180,60,4,3870.83,5,2,3,10,At Risk,1
1181,45,10,9928.33,6,7,9,22,Loyal Customers,2
1182,6,6,6422.9400000000005,10,4,6,20,Loyal Customers,0
1183,154,5,7060.07,1,3,7,11,At Risk,3
1184,6,6,7155.030000000001,10,4,7,21,Loyal Customers,2
1185,10,3,1957.15,9,1,1,11,At Risk,0
1186,38,4,3285.92,6,2,2,10,At Risk,0
1187,59,3,1634.25,5,1,1,7,Lost Customers,1
1188,19,2,3043.9,8,1,2,11,At Risk,0
1189,48,4,2894.1,5,2,2,9,Lost Customers,1
1190,7,6,4050.13,10,4,3,17,Potential Loyalist,0
1191,44,8,6925.33,6,6,7,19,Potential Loyalist,2
1192,80,5,4306.09,3,3,3,9,Lost Customers,1
1193,37,4,4694.62,6,2,4,12,At Risk,0
1194,29,8,7829.33,7,6,8,21,Loyal Customers,2
1195,20,5,5178.38,8,3,5,16,Potential Loyalist,0
1196,19,6,5307.82,8,4,5,17,Potential Loyalist,0
1197,8,4,4455.89,10,2,4,16,Potential Loyalist,0
1198,69,6,6397.58,4,4,6,14,At Risk,3
1199,44,8,6090.45,6,6,6,18,Potential Loyalist,3
1200,80,8,5923.110000000001,3,6,6,15,Potential Loyalist,3
1201,83,3,2329.42,3,1,1,5,Lost Customers,1
1202,86,2,3753.17,3,1,3,7,Lost Customers,1
1203,8,1,1036.59,10,1,1,12,At Risk,0
1204,201,1,235.63,1,1,1,3,Lost Customers,1
1205,69,6,7526.59,4,4,8,16,Potential Loyalist,3
1206,84,2,3229.76,3,1,2,6,Lost Customers,1
1207,14,6,4027.6,9,4,3,16,Potential Loyalist,0
1208,78,5,6789.07,4,3,7,14,At Risk,3
1209,132,2,2368.55,2,1,1,4,Lost Customers,1
1210,18,8,9667.75,8,6,9,23,Loyal Customers,2
1211,235,4,2677.25,1,2,2,5,Lost Customers,1
1212,72,3,3843.34,4,1,3,8,Lost Customers,1
1213,70,7,8448.45,4,5,8,17,Potential Loyalist,3
1214,24,4,4251.7,8,2,3,13,At Risk,0
1215,78,8,7611.6,4,6,8,18,Potential Loyalist,3
1216,8,3,3294.19,10,1,2,13,At Risk,0
1217,11,7,8001.530000000001,9,5,8,22,Loyal Customers,2
1218,51,6,8266.59,5,4,8,17,Potential Loyalist,3
1219,5,3,3070.27,10,1,2,13,At Risk,0
1220,67,5,5406.34,4,3,5,12,At Risk,3
1221,10,7,5309.76,9,5,5,19,Potential Loyalist,0
1222,52,3,2947.03,5,1,2,8,Lost Customers,1
1223,35,7,3920.52,6,5,3,14,At Risk,0
1224,48,7,8166.93,5,5,8,18,Potential Loyalist,3
1225,59,4,5271.6,5,2,5,12,At Risk,0
1226,25,5,5188.65,7,3,5,15,Potential Loyalist,0
1227,62,12,9340.67,4,7,9,20,Loyal Customers,3
1228,133,4,3561.17,2,2,2,6,Lost Customers,1
1229,20,9,6854.87,8,6,7,21,Loyal Customers,2
1230,77,2,1824.33,4,1,1,6,Lost Customers,1
1231,176,2,2000.5500000000002,1,1,1,3,Lost Customers,1
1232,5,9,10746.19,10,6,10,26,Best Customers,2
1233,15,9,11281.31,9,6,10,25,Best Customers,2
1234,86,7,6365.5599999999995,3,5,6,14,At Risk,3
1235,82,2,3981.8599999999997,3,1,3,7,Lost Customers,1
1236,42,4,4306.97,6,2,3,11,At Risk,0
1237,24,10,12299.65,8,7,10,25,Best Customers,2
1238,102,4,1827.7399999999998,3,2,1,6,Lost Customers,1
1239,39,7,4496.44,6,5,4,15,Potential Loyalist,0
1240,6,4,4634.82,10,2,4,16,Potential Loyalist,0
1241,76,7,7065.74,4,5,7,16,Potential Loyalist,3
1242,18,2,2610.13,8,1,2,11,At Risk,0
1243,200,9,10166.91,1,6,10,17,Potential Loyalist,3
1244,20,5,4737.43,8,3,4,15,Potential Loyalist,0
1245,72,7,5886.29,4,5,6,15,Potential Loyalist,3
1246,115,2,2963.46,2,1,2,5,Lost Customers,1
1247,91,4,5835.85,3,2,6,11,At Risk,3
1248,68,1,1661.92,4,1,1,6,Lost Customers,1
1249,107,5,6448.09,2,3,6,11,At Risk,3
1250,36,10,9534.19,6,7,9,22,Loyal Customers,2
1251,62,4,2360.34,4,2,1,7,Lost Customers,1
1252,10,7,9665.09,9,5,9,23,Loyal Customers,2
1253,5,4,3836.34,10,2,3,15,Potential Loyalist,0
1254,38,7,6791.62,6,5,7,18,Potential Loyalist,3
1255,79,3,1726.6999999999998,3,1,1,5,Lost Customers,1
1256,82,6,6083.15,3,4,6,13,At Risk,3
1257,257,3,2708.91,1,1,2,4,Lost Customers,1
1258,53,8,8945.56,5,6,9,20,Loyal Customers,3
1259,42,7,8470.17,6,5,8,19,Potential Loyalist,2
1260,67,5,3845.9700000000003,4,3,3,10,At Risk,1
1261,49,6,4878.62,5,4,4,13,At Risk,0
1262,44,3,4584.04,6,1,4,11,At Risk,0
1263,43,6,5354.29,6,4,5,15,Potential Loyalist,0
1264,3,4,6000.92,10,2,6,18,Potential Loyalist,0
1265,8,4,4449.86,10,2,4,16,Potential Loyalist,0
1266,258,2,4182.94,1,1,3,5,Lost Customers,1
1267,142,4,6352.41,2,2,6,10,At Risk,3
1268,68,3,3021.9300000000003,4,1,2,7,Lost Customers,1
1269,212,3,2962.88,1,1,2,4,Lost Customers,1
1270,206,4,3962.16,1,2,3,6,Lost Customers,1
1271,188,2,3387.5299999999997,1,1,2,4,Lost Customers,1
1272,25,9,11128.6,7,6,10,23,Loyal Customers,2
1273,24,3,3050.3100000000004,8,1,2,11,At Risk,0
1274,15,9,6912.77,9,6,7,22,Loyal Customers,2
1275,150,6,5698.139999999999,1,4,5,10,At Risk,3
1276,101,2,2585.3,3,1,1,5,Lost Customers,1
1277,56,3,2701.3900000000003,5,1,2,8,Lost Customers,1
1278,65,4,6559.17,4,2,7,13,At Risk,3
1279,53,6,6106.63,5,4,6,15,Potential Loyalist,3
1280,107,4,4802.049999999999,2,2,4,8,Lost Customers,1
1281,88,3,3403.18,3,1,2,6,Lost Customers,1
1282,39,8,10069.949999999999,6,6,10,22,Loyal Customers,2
1283,94,2,2964.4,3,1,2,6,Lost Customers,1
1284,79,3,418.80999999999995,3,1,1,5,Lost Customers,1
1285,119,7,10581.32,2,5,10,17,Potential Loyalist,3
1286,52,7,6400.92,5,5,6,16,Potential Loyalist,3
1287,68,7,9575.2,4,5,9,18,Potential Loyalist,3
1288,23,4,5733.47,8,2,5,15,Potential Loyalist,0
1289,12,6,5578.72,9,4,5,18,Potential Loyalist,0
1290,45,9,11890.97,6,6,10,22,Loyal Customers,2
1291,17,7,8651.92,8,5,9,22,Loyal Customers,2
1292,32,5,6404.32,7,3,6,16,Potential Loyalist,0
1293,240,5,5896.44,1,3,6,10,At Risk,3
1294,177,3,1722.97,1,1,1,3,Lost Customers,1
1295,30,6,5147.23,7,4,5,16,Potential Loyalist,0
1296,131,4,5977.84,2,2,6,10,At Risk,3
1297,3,6,6037.48,10,4,6,20,Loyal Customers,0
1298,142,5,7471.98,2,3,8,13,At Risk,3
1299,7,7,9845.31,10,5,9,24,Loyal Customers,2
1300,21,6,9217.35,8,4,9,21,Loyal Customers,2
1301,13,8,5396.44,9,6,5,20,Loyal Customers,2
1302,30,13,17035.83,7,7,10,24,Loyal Customers,2
1303,11,6,7278.72,9,4,7,20,Loyal Customers,2
1304,4,6,4316.4400000000005,10,4,3,17,Potential Loyalist,0
1305,143,5,4862.79,2,3,4,9,Lost Customers,1
1306,137,5,5037.3,2,3,4,9,Lost Customers,1
1307,91,9,9888.54,3,6,9,18,Potential Loyalist,3
1308,16,5,7509.25,8,3,8,19,Potential Loyalist,2
1309,83,4,3547.44,3,2,2,7,Lost Customers,1
1310,21,5,4177.02,8,3,3,14,At Risk,0
1311,48,3,4724.29,5,1,4,10,At Risk,1
1312,27,4,3066.41,7,2,2,11,At Risk,0
1313,8,7,8113.21,10,5,8,23,Loyal Customers,2
1314,28,5,5627.01,7,3,5,15,Potential Loyalist,0
1315,6,8,5675.12,10,6,5,21,Loyal Customers,2
1316,33,5,5704.709999999999,7,3,5,15,Potential Loyalist,0
1317,11,9,15370.81,9,6,10,25,Best Customers,2
1318,8,7,7834.26,10,5,8,23,Loyal Customers,2
1319,17,3,3463.61,8,1,2,11,At Risk,0
1320,95,6,4696.18,3,4,4,11,At Risk,1
1321,104,7,5511.14,2,5,5,12,At Risk,3
1322,64,4,6024.35,4,2,6,12,At Risk,3
1323,54,7,3352.15,5,5,2,12,At Risk,0
1324,75,6,6148.34,4,4,6,14,At Risk,3
1325,83,1,416.98,3,1,1,5,Lost Customers,1
1326,11,6,6384.110000000001,9,4,6,19,Potential Loyalist,0
1327,7,5,5206.27,10,3,5,18,Potential Loyalist,0
1328,1,7,10301.23,10,5,10,25,Best Customers,2
1329,5,10,13334.92,10,7,10,27,Best Customers,2
1330,76,6,8329.24,4,4,8,16,Potential Loyalist,3
1331,6,10,11641.26,10,7,10,27,Best Customers,2
1332,36,7,7755.36,6,5,8,19,Potential Loyalist,2
1333,8,3,3501.9,10,1,2,13,At Risk,0
1334,241,2,3129.3199999999997,1,1,2,4,Lost Customers,1
1335,53,7,7295.27,5,5,7,17,Potential Loyalist,3
1336,79,6,6095.66,3,4,6,13,At Risk,3
1337,84,6,6160.39,3,4,6,13,At Risk,3
1338,232,2,1671.8400000000001,1,1,1,3,Lost Customers,1
1339,103,5,6447.48,3,3,6,12,At Risk,3
1340,29,8,7371.42,7,6,7,20,Loyal Customers,2
1341,11,4,2841.1,9,2,2,13,At Risk,0
1342,4,4,4066.81,10,2,3,15,Potential Loyalist,0
1343,21,3,3737.68,8,1,3,12,At Risk,0
1344,22,3,1709.46,8,1,1,10,At Risk,0
1345,44,6,8121.72,6,4,8,18,Potential Loyalist,3
1346,16,9,10530.7,8,6,10,24,Loyal Customers,2
1347,92,6,6106.51,3,4,6,13,At Risk,3
1348,115,5,7592.16,2,3,8,13,At Risk,3
1349,44,6,4387.99,6,4,3,13,At Risk,0
1350,117,2,2243.46,2,1,1,4,Lost Customers,1
1351,18,6,8020.08,8,4,8,20,Loyal Customers,2
1352,89,3,2496.04,3,1,1,5,Lost Customers,1
1353,15,8,6708.35,9,6,7,22,Loyal Customers,2
1354,75,3,3170.25,4,1,2,7,Lost Customers,1
1355,9,5,5458.110000000001,9,3,5,17,Potential Loyalist,0
1356,23,6,6474.389999999999,8,4,6,18,Potential Loyalist,0
1357,13,9,12232.58,9,6,10,25,Best Customers,2
1358,4,8,8559.16,10,6,9,25,Best Customers,2
1359,13,2,2027.25,9,1,1,11,At Risk,0
1360,182,3,3476.3199999999997,1,1,2,4,Lost Customers,1
1361,29,6,7203.26,7,4,7,18,Potential Loyalist,2
1362,119,2,2948.34,2,1,2,5,Lost Customers,1
1363,25,7,7017.55,7,5,7,19,Potential Loyalist,2
1364,65,4,3804.88,4,2,3,9,Lost Customers,1
1365,218,4,2346.0800000000004,1,2,1,4,Lost Customers,1
1366,55,5,4035.11,5,3,3,11,At Risk,1
1367,12,7,4991.900000000001,9,5,4,18,Potential Loyalist,0
1368,49,6,6882.69,5,4,7,16,Potential Loyalist,3
1369,179,4,4920.55,1,2,4,7,Lost Customers,1
1370,27,4,3173.01,7,2,2,11,At Risk,0
1371,27,4,4146.6,7,2,3,12,At Risk,0
1372,67,6,6444.01,4,4,6,14,At Risk,3
1374,40,8,11213.68,6,6,10,22,Loyal Customers,2
1375,83,5,6008.95,3,3,6,12,At Risk,3
1376,90,6,6902.15,3,4,7,14,At Risk,3
1377,76,5,5783.17,4,3,5,12,At Risk,3
1378,13,6,8072.719999999999,9,4,8,21,Loyal Customers,2
1379,29,5,6509.42,7,3,6,16,Potential Loyalist,0
1380,199,3,4100.01,1,1,3,5,Lost Customers,1
1381,114,5,7293.99,2,3,7,12,At Risk,3
1382,123,2,2998.29,2,1,2,5,Lost Customers,1
1383,58,3,4082.21,5,1,3,9,Lost Customers,1
1384,37,6,6268.25,6,4,6,16,Potential Loyalist,3
1385,143,5,7432.72,2,3,7,12,At Risk,3
1386,107,3,3260.21,2,1,2,5,Lost Customers,1
1387,216,1,1635.3,1,1,1,3,Lost Customers,1
1388,20,6,6237.99,8,4,6,18,Potential Loyalist,0
1389,50,8,10208.73,5,6,10,21,Loyal Customers,3
1390,2,9,9070.85,10,6,9,25,Best Customers,2
1391,64,3,3611.7799999999997,4,1,2,7,Lost Customers,1
1392,108,3,4481.38,2,1,4,7,Lost Customers,1
1393,31,2,1674.72,7,1,1,9,Lost Customers,0
1394,172,4,4565.360000000001,1,2,4,7,Lost Customers,1
1395,88,2,2860.38,3,1,2,6,Lost Customers,1
1396,10,10,11434.630000000001,9,7,10,26,Best Customers,2
1397,138,6,7257.49,2,4,7,13,At Risk,3
1398,37,7,8073.77,6,5,8,19,Potential Loyalist,2
1399,17,4,6034.2,8,2,6,16,Potential Loyalist,0
1400,57,6,7408.41,5,4,7,16,Potential Loyalist,3
1401,82,4,3740.62,3,2,3,8,Lost Customers,1
1402,41,8,7968.53,6,6,8,20,Loyal Customers,2
1403,165,2,1663.42,1,1,1,3,Lost Customers,1
1404,8,10,9401.710000000001,10,7,9,26,Best Customers,2
1405,34,11,7668.83,7,7,8,22,Loyal Customers,2
1406,29,6,4605.35,7,4,4,15,Potential Loyalist,0
1407,1,9,9199.51,10,6,9,25,Best Customers,2
1408,11,3,4975.92,9,1,4,14,At Risk,0
1409,23,4,5869.55,8,2,6,16,Potential Loyalist,0
1410,61,7,10217.49,5,5,10,20,Loyal Customers,3
1411,36,6,8273.8,6,4,8,18,Potential Loyalist,3
1412,122,4,3403.46,2,2,2,6,Lost Customers,1
1413,4,6,5581.84,10,4,5,19,Potential Loyalist,0
1414,19,2,1758.44,8,1,1,10,At Risk,0
1415,58,4,4962.58,5,2,4,11,At Risk,1
1416,115,4,3443.91,2,2,2,6,Lost Customers,1
1417,57,7,9187.68,5,5,9,19,Potential Loyalist,3
1418,87,5,5545.360000000001,3,3,5,11,At Risk,3
1419,23,5,3385.2400000000002,8,3,2,13,At Risk,0
1420,39,5,4965.84,6,3,4,13,At Risk,0
1421,58,6,5452.030000000001,5,4,5,14,At Risk,3
1422,48,6,4684.3,5,4,4,13,At Risk,0
1423,25,6,7143.39,7,4,7,18,Potential Loyalist,2
1424,77,3,3560.7,4,1,2,7,Lost Customers,1
1425,1,4,4470.96,10,2,4,16,Potential Loyalist,0
1426,49,7,5955.06,5,5,6,16,Potential Loyalist,3
1427,60,5,5854.77,5,3,6,14,At Risk,3
1428,16,10,11559.73,8,7,10,25,Best Customers,2
1429,32,6,3862.72,7,4,3,14,At Risk,0
1430,109,5,4676.59,2,3,4,9,Lost Customers,1
1431,20,4,3180.44,8,2,2,12,At Risk,0
1432,34,6,5329.7300000000005,7,4,5,16,Potential Loyalist,0
1433,132,3,4030.1099999999997,2,1,3,6,Lost Customers,1
1434,125,2,2016.27,2,1,1,4,Lost Customers,1
1435,34,7,8853.71,7,5,9,21,Loyal Customers,2
1436,73,5,5911.139999999999,4,3,6,13,At Risk,3
1437,144,3,3495.9300000000003,2,1,2,5,Lost Customers,1
1438,7,10,10627.41,10,7,10,27,Best Customers,2
1439,66,3,3310.83,4,1,2,7,Lost Customers,1
1440,20,6,8415.02,8,4,8,20,Loyal Customers,2
1441,159,2,1628.66,1,1,1,3,Lost Customers,1
1442,54,2,299.37,5,1,1,7,Lost Customers,1
1443,45,10,10803.14,6,7,10,23,Loyal Customers,2
1444,39,5,2497.0699999999997,6,3,1,10,At Risk,0
1445,7,6,8482.71,10,4,8,22,Loyal Customers,2
1446,11,7,9653.68,9,5,9,23,Loyal Customers,2
1447,98,7,8905.630000000001,3,5,9,17,Potential Loyalist,3
1448,238,1,642.31,1,1,1,3,Lost Customers,1
1449,15,6,8326.130000000001,9,4,8,21,Loyal Customers,2
1450,43,7,8942.8,6,5,9,20,Loyal Customers,2
1451,84,6,5516.52,3,4,5,12,At Risk,3
1452,3,5,5937.9800000000005,10,3,6,19,Potential Loyalist,0
1453,1,5,6332.4,10,3,6,19,Potential Loyalist,0
1454,6,4,3856.7,10,2,3,15,Potential Loyalist,0
1455,33,4,4018.67,7,2,3,12,At Risk,0
1456,9,4,1713.83,9,2,1,12,At Risk,0
1457,66,6,6224.22,4,4,6,14,At Risk,3
1458,199,3,4366.14,1,1,3,5,Lost Customers,1
1459,99,4,5707.43,3,2,5,10,At Risk,1
1460,13,8,14633.24,9,6,10,25,Best Customers,2
1461,19,7,8475.94,8,5,8,21,Loyal Customers,2
1462,82,5,3667.8699999999994,3,3,3,9,Lost Customers,1
1463,111,5,5593.08,2,3,5,10,At Risk,1
1464,107,6,4553.66,2,4,4,10,At Risk,1
1465,108,4,3709.83,2,2,3,7,Lost Customers,1
1466,34,3,3383.13,7,1,2,10,At Risk,0
1467,14,7,5883.48,9,5,6,20,Loyal Customers,2
1468,110,6,7218.12,2,4,7,13,At Risk,3
1469,75,6,5088.71,4,4,5,13,At Risk,3
1470,2,7,7379.799999999999,10,5,7,22,Loyal Customers,2
1471,6,4,5207.27,10,2,5,17,Potential Loyalist,0
1472,70,7,8646.38,4,5,9,18,Potential Loyalist,3
1473,33,11,11098.84,7,7,10,24,Loyal Customers,2
1474,67,5,5061.36,4,3,4,11,At Risk,1
1475,47,7,10929.810000000001,5,5,10,20,Loyal Customers,3
1476,25,2,2055.69,7,1,1,9,Lost Customers,0
1477,20,9,9549.97,8,6,9,23,Loyal Customers,2
1478,2,7,6907.85,10,5,7,22,Loyal Customers,2
1479,70,4,3581.89,4,2,2,8,Lost Customers,1
1480,3,9,7182.38,10,6,7,23,Loyal Customers,2
1481,21,8,7837.75,8,6,8,22,Loyal Customers,2
1482,69,12,14366.26,4,7,10,21,Loyal Customers,3
1483,30,8,7979.17,7,6,8,21,Loyal Customers,2
1484,15,4,3395.02,9,2,2,13,At Risk,0
1485,5,2,1871.67,10,1,1,12,At Risk,0
1486,33,5,4895.26,7,3,4,14,At Risk,0
1487,18,2,617.38,8,1,1,10,At Risk,0
1488,41,1,533.51,6,1,1,8,Lost Customers,0
1489,83,4,2348.25,3,2,1,6,Lost Customers,1
1490,69,4,4593.42,4,2,4,10,At Risk,1
1491,161,3,3208.6000000000004,1,1,2,4,Lost Customers,1
1492,14,7,10034.769999999999,9,5,9,23,Loyal Customers,2
1493,21,10,11653.87,8,7,10,25,Best Customers,2
1494,19,10,11747.52,8,7,10,25,Best Customers,2
1495,4,2,1217.97,10,1,1,12,At Risk,0
1496,54,5,7189.5,5,3,7,15,Potential Loyalist,3
1497,183,6,6257.94,1,4,6,11,At Risk,3
1498,41,4,4031.87,6,2,3,11,At Risk,0
1499,126,5,5880.2699999999995,2,3,6,11,At Risk,3
1500,6,5,7075.5599999999995,10,3,7,20,Loyal Customers,2
1501,54,5,4317.1,5,3,3,11,At Risk,1
1502,27,9,11571.9,7,6,10,23,Loyal Customers,2
1503,161,8,12553.88,1,6,10,17,Potential Loyalist,3
1504,6,5,5266.7,10,3,5,18,Potential Loyalist,0
1505,19,4,5210.83,8,2,5,15,Potential Loyalist,0
1506,1,10,11058.14,10,7,10,27,Best Customers,2
1507,17,3,5420.97,8,1,5,14,At Risk,0
1508,62,5,5437.08,4,3,5,12,At Risk,3
1509,45,3,2949.6800000000003,6,1,2,9,Lost Customers,0
1510,57,2,2588.77,5,1,1,7,Lost Customers,1
1511,17,8,7012.24,8,6,7,21,Loyal Customers,2
1512,137,3,4304.62,2,1,3,6,Lost Customers,1
1513,121,6,5632.32,2,4,5,11,At Risk,3
1514,68,7,7863.42,4,5,8,17,Potential Loyalist,3
1515,9,7,5844.51,9,5,6,20,Loyal Customers,2
1516,38,5,5692.96,6,3,5,14,At Risk,0
1517,29,11,13750.08,7,7,10,24,Loyal Customers,2
1518,92,4,4780.57,3,2,4,9,Lost Customers,1
1519,9,11,9090.05,9,7,9,25,Best Customers,2
1520,168,4,4369.87,1,2,3,6,Lost Customers,1
1521,96,2,2287.37,3,1,1,5,Lost Customers,1
1522,10,5,5030.57,9,3,4,16,Potential Loyalist,0
1523,42,3,3736.42,6,1,3,10,At Risk,0
1524,38,8,5784.92,6,6,5,17,Potential Loyalist,3
1525,25,3,2983.65,7,1,2,10,At Risk,0
1526,112,5,7076.29,2,3,7,12,At Risk,3
1527,42,8,8695.82,6,6,9,21,Loyal Customers,2
1528,76,7,7880.17,4,5,8,17,Potential Loyalist,3
1529,105,1,1810.0,2,1,1,4,Lost Customers,1
1530,2,10,13634.73,10,7,10,27,Best Customers,2
1531,43,7,7667.54,6,5,8,19,Potential Loyalist,2
1532,4,6,6446.1900000000005,10,4,6,20,Loyal Customers,0
1533,105,8,7532.76,2,6,8,16,Potential Loyalist,3
1534,47,7,7048.71,5,5,7,17,Potential Loyalist,3
1535,105,5,7008.0599999999995,2,3,7,12,At Risk,3
1536,34,4,4914.46,7,2,4,13,At Risk,0
1537,27,9,9589.18,7,6,9,22,Loyal Customers,2
1538,2,4,891.12,10,2,1,13,At Risk,0
1539,66,8,6655.98,4,6,7,17,Potential Loyalist,3
1540,6,5,5874.45,10,3,6,19,Potential Loyalist,0
1541,71,5,6311.2,4,3,6,13,At Risk,3
1542,134,5,5625.49,2,3,5,10,At Risk,1
1543,75,3,2638.73,4,1,2,7,Lost Customers,1
1544,330,1,1057.51,1,1,1,3,Lost Customers,1
1545,3,7,6179.73,10,5,6,21,Loyal Customers,2
1546,70,6,6116.7300000000005,4,4,6,14,At Risk,3
1547,28,9,12870.9,7,6,10,23,Loyal Customers,2
1548,38,3,2239.69,6,1,1,8,Lost Customers,0
1549,4,7,5720.9800000000005,10,5,5,20,Loyal Customers,0
1550,43,6,5181.85,6,4,5,15,Potential Loyalist,0
1551,23,7,7800.78,8,5,8,21,Loyal Customers,2
1552,100,5,6945.16,3,3,7,13,At Risk,3
1553,85,4,4422.05,3,2,4,9,Lost Customers,1
1554,21,7,9898.23,8,5,9,22,Loyal Customers,2
1555,134,7,7885.78,2,5,8,15,Potential Loyalist,3
1556,85,5,6248.45,3,3,6,12,At Risk,3
1557,76,6,9663.51,4,4,9,17,Potential Loyalist,3
1558,9,9,13587.269999999999,9,6,10,25,Best Customers,2
1559,57,7,10631.65,5,5,10,20,Loyal Customers,3
1560,203,3,1348.02,1,1,1,3,Lost Customers,1
1561,44,8,10601.55,6,6,10,22,Loyal Customers,2
1562,101,3,4066.11,3,1,3,7,Lost Customers,1
1563,130,4,4845.110000000001,2,2,4,8,Lost Customers,1
1564,14,3,2983.8,9,1,2,12,At Risk,0
1565,10,2,3083.23,9,1,2,12,At Risk,0
1566,87,4,2886.44,3,2,2,7,Lost Customers,1
1567,25,7,10643.93,7,5,10,22,Loyal Customers,2
1568,140,4,6373.65,2,2,6,10,At Risk,3
1569,54,1,1466.68,5,1,1,7,Lost Customers,1
1570,34,9,9958.95,7,6,9,22,Loyal Customers,2
1571,4,4,6221.7300000000005,10,2,6,18,Potential Loyalist,0
1572,83,6,10119.88,3,4,10,17,Potential Loyalist,3
1573,65,4,5400.4400000000005,4,2,5,11,At Risk,1
1574,74,10,9813.75,4,7,9,20,Loyal Customers,3
1575,87,4,4088.84,3,2,3,8,Lost Customers,1
1576,38,7,7829.95,6,5,8,19,Potential Loyalist,2
1577,13,7,7980.92,9,5,8,22,Loyal Customers,2
1578,17,7,9064.42,8,5,9,22,Loyal Customers,2
1579,41,10,12087.02,6,7,10,23,Loyal Customers,2
1580,56,8,7454.8099999999995,5,6,8,19,Potential Loyalist,3
1581,37,8,7922.66,6,6,8,20,Loyal Customers,2
1582,56,5,5202.889999999999,5,3,5,13,At Risk,3
1583,113,4,4888.05,2,2,4,8,Lost Customers,1
1584,3,2,2749.7200000000003,10,1,2,13,At Risk,0
1585,38,8,8002.97,6,6,8,20,Loyal Customers,2
1586,17,6,6104.44,8,4,6,18,Potential Loyalist,0
1587,78,5,4992.59,4,3,4,11,At Risk,1
1588,33,7,9131.54,7,5,9,21,Loyal Customers,2
1589,12,6,8549.57,9,4,9,22,Loyal Customers,2
1590,87,3,5130.389999999999,3,1,5,9,Lost Customers,1
1591,30,11,12687.66,7,7,10,24,Loyal Customers,2
1592,101,4,5703.379999999999,3,2,5,10,At Risk,1
1593,54,6,7569.45,5,4,8,17,Potential Loyalist,3
1594,1,5,6384.16,10,3,6,19,Potential Loyalist,0
1595,78,7,9792.89,4,5,9,18,Potential Loyalist,3
1596,136,3,4400.92,2,1,3,6,Lost Customers,1
1597,26,11,16245.23,7,7,10,24,Loyal Customers,2
1598,171,5,6297.23,1,3,6,10,At Risk,3
1599,20,11,8164.88,8,7,8,23,Loyal Customers,2
1600,14,9,5904.32,9,6,6,21,Loyal Customers,2
1601,20,4,3901.84,8,2,3,13,At Risk,0
1602,8,4,4971.84,10,2,4,16,Potential Loyalist,0
1603,24,4,5471.889999999999,8,2,5,15,Potential Loyalist,0
1604,100,3,3311.7200000000003,3,1,2,6,Lost Customers,1
1605,182,3,3871.88,1,1,3,5,Lost Customers,1
1606,43,4,5390.66,6,2,5,13,At Risk,0
1607,2,5,4898.71,10,3,4,17,Potential Loyalist,0
1608,13,3,2811.51,9,1,2,12,At Risk,0
1609,62,5,6259.92,4,3,6,13,At Risk,3
1610,9,5,6734.610000000001,9,3,7,19,Potential Loyalist,2
1611,42,12,13692.47,6,7,10,23,Loyal Customers,2
1612,68,2,3904.22,4,1,3,8,Lost Customers,1
1613,42,8,6670.94,6,6,7,19,Potential Loyalist,2
1614,51,6,4720.15,5,4,4,13,At Risk,0
1615,56,5,7708.12,5,3,8,16,Potential Loyalist,3
1616,24,7,10413.51,8,5,10,23,Loyal Customers,2
1617,6,5,5926.27,10,3,6,19,Potential Loyalist,0
1618,29,2,2033.21,7,1,1,9,Lost Customers,0
1619,85,10,11466.11,3,7,10,20,Loyal Customers,3
1620,217,2,2947.04,1,1,2,4,Lost Customers,1
1621,83,5,2804.08,3,3,2,8,Lost Customers,1
1622,48,3,1952.29,5,1,1,7,Lost Customers,1
1623,3,6,7686.06,10,4,8,22,Loyal Customers,2
1624,4,6,4424.39,10,4,4,18,Potential Loyalist,0
1625,10,8,12809.369999999999,9,6,10,25,Best Customers,2
1626,256,2,1789.3799999999999,1,1,1,3,Lost Customers,1
1627,25,8,10051.58,7,6,9,22,Loyal Customers,2
1628,134,2,3869.2699999999995,2,1,3,6,Lost Customers,1
1629,2,7,8226.210000000001,10,5,8,23,Loyal Customers,2
1630,24,3,3699.7799999999997,8,1,3,12,At Risk,0
1631,132,4,4179.64,2,2,3,7,Lost Customers,1
1632,282,1,1538.99,1,1,1,3,Lost Customers,1
1633,18,3,4623.68,8,1,4,13,At Risk,0
1634,30,4,3683.93,7,2,3,12,At Risk,0
1635,140,4,6745.71,2,2,7,11,At Risk,3
1636,41,5,6065.61,6,3,6,15,Potential Loyalist,0
1637,144,7,7511.01,2,5,8,15,Potential Loyalist,3
1638,12,4,5237.9,9,2,5,16,Potential Loyalist,0
1639,31,6,7481.219999999999,7,4,8,19,Potential Loyalist,2
1640,63,7,5455.04,4,5,5,14,At Risk,3
1641,64,9,9474.24,4,6,9,19,Potential Loyalist,3
1642,85,5,4353.22,3,3,3,9,Lost Customers,1
1643,39,8,9571.34,6,6,9,21,Loyal Customers,2
1644,23,7,8493.64,8,5,8,21,Loyal Customers,2
1645,91,7,4521.049999999999,3,5,4,12,At Risk,3
1646,27,7,7426.27,7,5,7,19,Potential Loyalist,2
1647,179,7,7932.610000000001,1,5,8,14,At Risk,3
1648,14,4,4946.86,9,2,4,15,Potential Loyalist,0
1649,72,2,3582.3900000000003,4,1,2,7,Lost Customers,1
1650,11,5,4358.9,9,3,3,15,Potential Loyalist,0
1651,98,5,2070.12,3,3,1,7,Lost Customers,1
1652,97,6,7230.45,3,4,7,14,At Risk,3
1653,34,4,4606.14,7,2,4,13,At Risk,0
1654,85,4,4021.4700000000003,3,2,3,8,Lost Customers,1
1655,17,3,3331.17,8,1,2,11,At Risk,0
1656,85,6,6391.54,3,4,6,13,At Risk,3
1657,62,5,5480.33,4,3,5,12,At Risk,3
1658,281,4,3729.5499999999997,1,2,3,6,Lost Customers,1
1659,81,7,8004.33,3,5,8,16,Potential Loyalist,3
1660,77,6,4480.62,4,4,4,12,At Risk,1
1661,219,6,8438.94,1,4,8,13,At Risk,3
1662,63,5,3125.38,4,3,2,9,Lost Customers,1
1663,14,6,8093.37,9,4,8,21,Loyal Customers,2
1664,43,7,8460.32,6,5,8,19,Potential Loyalist,2
1665,69,7,6247.18,4,5,6,15,Potential Loyalist,3
1666,79,4,5256.49,3,2,5,10,At Risk,1
1667,77,7,9549.75,4,5,9,18,Potential Loyalist,3
1668,5,6,6878.43,10,4,7,21,Loyal Customers,2
1669,60,6,6940.13,5,4,7,16,Potential Loyalist,3
1670,61,9,8855.96,5,6,9,20,Loyal Customers,3
1671,44,4,3197.84,6,2,2,10,At Risk,0
1672,43,11,11450.34,6,7,10,23,Loyal Customers,2
1673,134,3,1318.28,2,1,1,4,Lost Customers,1
1674,49,5,1043.7,5,3,1,9,Lost Customers,1
1675,102,4,4572.34,3,2,4,9,Lost Customers,1
1676,88,5,6881.58,3,3,7,13,At Risk,3
1677,99,8,8188.179999999999,3,6,8,17,Potential Loyalist,3
1678,69,9,8841.869999999999,4,6,9,19,Potential Loyalist,3
1679,137,4,5682.89,2,2,5,9,Lost Customers,1
1680,113,3,5001.21,2,1,4,7,Lost Customers,1
1681,19,5,5956.62,8,3,6,17,Potential Loyalist,0
1682,83,6,10071.44,3,4,10,17,Potential Loyalist,3
1683,83,9,12412.95,3,6,10,19,Potential Loyalist,3
1684,17,6,4309.7,8,4,3,15,Potential Loyalist,0
1685,26,2,1818.98,7,1,1,9,Lost Customers,0
1686,79,10,10098.74,3,7,10,20,Loyal Customers,3
1687,11,4,4032.17,9,2,3,14,At Risk,0
1688,39,7,8556.73,6,5,9,20,Loyal Customers,2
1689,137,5,7091.33,2,3,7,12,At Risk,3
1690,17,9,8042.110000000001,8,6,8,22,Loyal Customers,2
1691,3,8,7630.41,10,6,8,24,Loyal Customers,2
1692,128,4,1987.2,2,2,1,5,Lost Customers,1
1693,76,6,6723.21,4,4,7,15,Potential Loyalist,3
1694,20,7,7616.63,8,5,8,21,Loyal Customers,2
1695,38,5,7504.66,6,3,8,17,Potential Loyalist,3
1696,29,9,12254.53,7,6,10,23,Loyal Customers,2
1697,25,5,6885.15,7,3,7,17,Potential Loyalist,2
1698,33,8,9039.039999999999,7,6,9,22,Loyal Customers,2
1699,82,7,6876.64,3,5,7,15,Potential Loyalist,3
1700,70,6,4957.01,4,4,4,12,At Risk,1
1701,6,5,3664.41,10,3,3,16,Potential Loyalist,0
1702,15,6,5455.59,9,4,5,18,Potential Loyalist,0
1703,4,4,2468.19,10,2,1,13,At Risk,0
1704,120,2,3009.57,2,1,2,5,Lost Customers,1
1705,16,4,5029.5,8,2,4,14,At Risk,0
1706,3,8,9107.39,10,6,9,25,Best Customers,2
1707,18,8,6588.76,8,6,7,21,Loyal Customers,2
1708,259,4,6112.64,1,2,6,9,Lost Customers,3
1709,5,5,5390.71,10,3,5,18,Potential Loyalist,0
1710,81,4,4067.49,3,2,3,8,Lost Customers,1
1711,42,7,6222.5599999999995,6,5,6,17,Potential Loyalist,3
1712,287,2,1953.53,1,1,1,3,Lost Customers,1
1713,7,7,9031.89,10,5,9,24,Loyal Customers,2
1714,39,6,5717.15,6,4,5,15,Potential Loyalist,0
1715,103,3,2616.3199999999997,3,1,2,6,Lost Customers,1
1716,135,2,2372.87,2,1,1,4,Lost Customers,1
1717,47,4,3349.03,5,2,2,9,Lost Customers,1
1718,25,5,4488.2,7,3,4,14,At Risk,0
1719,20,5,5061.53,8,3,4,15,Potential Loyalist,0
1720,24,5,5561.49,8,3,5,16,Potential Loyalist,0
1721,1,7,8195.2,10,5,8,23,Loyal Customers,2
1722,5,8,10751.44,10,6,10,26,Best Customers,2
1723,18,5,4943.21,8,3,4,15,Potential Loyalist,0
1724,104,4,2074.23,2,2,1,5,Lost Customers,1
1725,61,6,9306.93,5,4,9,18,Potential Loyalist,3
1726,118,5,7508.62,2,3,8,13,At Risk,3
1727,72,7,7397.04,4,5,7,16,Potential Loyalist,3
1728,46,6,7811.6,6,4,8,18,Potential Loyalist,3
1729,59,6,4397.5,5,4,3,12,At Risk,0
1730,21,3,3121.3,8,1,2,11,At Risk,0
1731,44,11,8015.92,6,7,8,21,Loyal Customers,2
1732,98,5,4804.96,3,3,4,10,At Risk,1
1733,54,5,4933.33,5,3,4,12,At Risk,0
1734,26,2,1998.5900000000001,7,1,1,9,Lost Customers,0
1735,66,4,4446.81,4,2,4,10,At Risk,1
1736,55,6,8725.86,5,4,9,18,Potential Loyalist,3
1737,46,3,4477.58,6,1,4,11,At Risk,0
1738,22,4,2808.24,8,2,2,12,At Risk,0
1739,38,4,4215.17,6,2,3,11,At Risk,0
1740,7,8,9327.380000000001,10,6,9,25,Best Customers,2
1741,65,3,4261.62,4,1,3,8,Lost Customers,1
1742,60,6,7168.48,5,4,7,16,Potential Loyalist,3
1743,87,7,8615.73,3,5,9,17,Potential Loyalist,3
1744,110,3,1889.09,2,1,1,4,Lost Customers,1
1745,6,12,10025.74,10,7,9,26,Best Customers,2
1746,106,6,8448.21,2,4,8,14,At Risk,3
1747,191,4,2839.33,1,2,2,5,Lost Customers,1
1748,3,10,11012.26,10,7,10,27,Best Customers,2
1749,82,3,3909.98,3,1,3,7,Lost Customers,1
1750,56,6,7768.64,5,4,8,17,Potential Loyalist,3
1751,13,4,3904.5699999999997,9,2,3,14,At Risk,0
1752,29,7,5387.53,7,5,5,17,Potential Loyalist,0
1753,28,4,4242.64,7,2,3,12,At Risk,0
1754,143,5,6904.57,2,3,7,12,At Risk,3
1755,49,6,6597.55,5,4,7,16,Potential Loyalist,3
1756,63,3,2636.84,4,1,2,7,Lost Customers,1
1757,230,1,1228.07,1,1,1,3,Lost Customers,1
1758,3,7,4887.03,10,5,4,19,Potential Loyalist,0
1759,19,6,5494.57,8,4,5,17,Potential Loyalist,0
1760,13,6,6410.4,9,4,6,19,Potential Loyalist,0
1761,19,5,5743.1,8,3,5,16,Potential Loyalist,0
1762,22,11,11211.63,8,7,10,25,Best Customers,2
1763,10,7,7841.49,9,5,8,22,Loyal Customers,2
1764,3,4,3350.1400000000003,10,2,2,14,At Risk,0
1765,47,6,8083.150000000001,5,4,8,17,Potential Loyalist,3
1766,179,5,3464.7,1,3,2,6,Lost Customers,1
1767,5,5,5973.14,10,3,6,19,Potential Loyalist,0
1768,93,1,945.04,3,1,1,5,Lost Customers,1
1769,37,6,5115.5,6,4,5,15,Potential Loyalist,0
1770,14,7,8228.41,9,5,8,22,Loyal Customers,2
1771,40,5,5464.37,6,3,5,14,At Risk,0
1772,169,4,4467.889999999999,1,2,4,7,Lost Customers,1
1773,9,10,12135.49,9,7,10,26,Best Customers,2
1774,98,4,3792.41,3,2,3,8,Lost Customers,1
1775,53,5,4881.53,5,3,4,12,At Risk,0
1776,35,6,6401.14,6,4,6,16,Potential Loyalist,3
1777,71,6,6896.08,4,4,7,15,Potential Loyalist,3
1778,313,2,3040.4,1,1,2,4,Lost Customers,1
1779,130,6,8886.92,2,4,9,15,Potential Loyalist,3
1780,39,4,4117.57,6,2,3,11,At Risk,0
1781,10,4,3282.18,9,2,2,13,At Risk,0
1782,82,5,7342.2,3,3,7,13,At Risk,3
1783,50,12,11248.25,5,7,10,22,Loyal Customers,2
1784,72,4,4486.610000000001,4,2,4,10,At Risk,1
1785,35,6,5294.27,6,4,5,15,Potential Loyalist,0
1786,175,2,1570.1,1,1,1,3,Lost Customers,1
1787,1,6,7519.39,10,4,8,22,Loyal Customers,2
1788,30,9,10584.15,7,6,10,23,Loyal Customers,2
1789,61,3,3728.3,5,1,3,9,Lost Customers,1
1790,33,5,4313.98,7,3,3,13,At Risk,0
1791,118,6,7479.16,2,4,8,14,At Risk,3
1792,7,9,8862.25,10,6,9,25,Best Customers,2
1793,61,6,7572.360000000001,5,4,8,17,Potential Loyalist,3
1794,2,4,3126.8999999999996,10,2,2,14,At Risk,0
1795,4,6,6133.57,10,4,6,20,Loyal Customers,0
1796,123,2,471.26,2,1,1,4,Lost Customers,1
1797,55,11,10502.99,5,7,10,22,Loyal Customers,2
1798,14,7,6605.389999999999,9,5,7,21,Loyal Customers,2
1799,53,4,4409.38,5,2,3,10,At Risk,1
1800,172,3,3565.92,1,1,2,4,Lost Customers,1
1801,66,8,9112.94,4,6,9,19,Potential Loyalist,3
1802,14,8,10435.94,9,6,10,25,Best Customers,2
1803,116,7,7116.29,2,5,7,14,At Risk,3
1804,32,3,4740.04,7,1,4,12,At Risk,0
1805,91,4,2108.15,3,2,1,6,Lost Customers,1
1806,38,8,8723.79,6,6,9,21,Loyal Customers,2
1807,61,6,6829.25,5,4,7,16,Potential Loyalist,3
1808,77,7,10837.15,4,5,10,19,Potential Loyalist,3
1809,28,6,10150.57,7,4,10,21,Loyal Customers,2
1810,7,2,458.74,10,1,1,12,At Risk,0
1811,33,8,10112.53,7,6,10,23,Loyal Customers,2
1812,23,9,10214.4,8,6,10,24,Loyal Customers,2
1813,19,6,6307.18,8,4,6,18,Potential Loyalist,0
1814,52,6,4848.03,5,4,4,13,At Risk,0
1815,12,5,4235.58,9,3,3,15,Potential Loyalist,0
1816,81,4,3471.65,3,2,2,7,Lost Customers,1
1817,32,11,10054.07,7,7,9,23,Loyal Customers,2
1818,25,7,8942.78,7,5,9,21,Loyal Customers,2
1819,253,2,2884.59,1,1,2,4,Lost Customers,1
1820,36,9,8429.29,6,6,8,20,Loyal Customers,2
1821,25,12,14387.59,7,7,10,24,Loyal Customers,2
1822,3,5,3009.41,10,3,2,15,Potential Loyalist,0
1823,162,6,6635.66,1,4,7,12,At Risk,3
1824,13,7,7059.410000000001,9,5,7,21,Loyal Customers,2
1825,41,6,6976.92,6,4,7,17,Potential Loyalist,3
1826,41,7,6983.06,6,5,7,18,Potential Loyalist,3
1827,39,4,5169.16,6,2,5,13,At Risk,0
1828,151,3,2146.84,1,1,1,3,Lost Customers,1
1829,4,3,2868.37,10,1,2,13,At Risk,0
1830,14,7,7237.05,9,5,7,21,Loyal Customers,2
1831,166,8,6774.88,1,6,7,14,At Risk,3
1832,85,8,9260.84,3,6,9,18,Potential Loyalist,3
1833,11,5,4197.33,9,3,3,15,Potential Loyalist,0
1834,127,4,6290.79,2,2,6,10,At Risk,3
1835,26,6,5273.87,7,4,5,16,Potential Loyalist,0
1836,167,2,2832.71,1,1,2,4,Lost Customers,1
1837,36,7,9763.42,6,5,9,20,Loyal Customers,2
1838,50,5,7121.110000000001,5,3,7,15,Potential Loyalist,3
1839,50,7,5930.82,5,5,6,16,Potential Loyalist,3
1840,99,7,6929.780000000001,3,5,7,15,Potential Loyalist,3
1841,37,3,4263.92,6,1,3,10,At Risk,0
1842,212,5,6542.54,1,3,6,10,At Risk,3
1843,113,4,5065.64,2,2,4,8,Lost Customers,1
1844,42,6,7356.040000000001,6,4,7,17,Potential Loyalist,3
1845,22,7,9342.199999999999,8,5,9,22,Loyal Customers,2
1846,334,1,441.49,1,1,1,3,Lost Customers,1
1847,33,3,3921.92,7,1,3,11,At Risk,0
1848,43,6,8432.48,6,4,8,18,Potential Loyalist,3
1849,137,6,7069.03,2,4,7,13,At Risk,3
1850,45,7,7706.74,6,5,8,19,Potential Loyalist,2
1851,286,2,2498.86,1,1,1,3,Lost Customers,1
1852,98,4,5547.41,3,2,5,10,At Risk,1
1853,27,9,8957.8,7,6,9,22,Loyal Customers,2
1854,1,3,3384.5600000000004,10,1,2,13,At Risk,0
1855,23,4,3648.1,8,2,3,13,At Risk,0
1856,128,2,1134.63,2,1,1,4,Lost Customers,1
1857,88,4,6171.18,3,2,6,11,At Risk,3
1858,22,8,12412.28,8,6,10,24,Loyal Customers,2
1859,77,5,6599.450000000001,4,3,7,14,At Risk,3
1860,12,5,5869.2,9,3,6,18,Potential Loyalist,0
1861,30,5,6015.5599999999995,7,3,6,16,Potential Loyalist,0
1862,75,7,6966.85,4,5,7,16,Potential Loyalist,3
1863,247,5,7359.9,1,3,7,11,At Risk,3
1864,25,10,7448.48,7,7,8,22,Loyal Customers,2
1865,100,1,1071.23,3,1,1,5,Lost Customers,1
1866,39,9,12450.76,6,6,10,22,Loyal Customers,2
1867,3,8,11055.86,10,6,10,26,Best Customers,2
1868,27,6,10105.23,7,4,10,21,Loyal Customers,2
1869,42,4,3260.59,6,2,2,10,At Risk,0
1870,39,7,7755.76,6,5,8,19,Potential Loyalist,2
1871,95,4,3787.27,3,2,3,8,Lost Customers,1
1872,140,5,5719.53,2,3,5,10,At Risk,1
1873,9,4,5930.68,9,2,6,17,Potential Loyalist,0
1874,100,5,3958.4700000000003,3,3,3,9,Lost Customers,1
1875,99,6,6549.05,3,4,6,13,At Risk,3
1876,139,5,10115.019999999999,2,3,10,15,Potential Loyalist,3
1877,81,6,4192.3099999999995,3,4,3,10,At Risk,1
1878,33,6,6231.59,7,4,6,17,Potential Loyalist,0
1879,48,7,5332.889999999999,5,5,5,15,Potential Loyalist,3
1880,68,5,6619.75,4,3,7,14,At Risk,3
1881,36,7,8559.33,6,5,9,20,Loyal Customers,2
1882,129,6,5862.02,2,4,6,12,At Risk,3
1883,43,3,4596.28,6,1,4,11,At Risk,0
1884,25,7,6672.0,7,5,7,19,Potential Loyalist,2
1885,5,9,10587.23,10,6,10,26,Best Customers,2
1886,7,4,4591.32,10,2,4,16,Potential Loyalist,0
1887,106,9,13551.54,2,6,10,18,Potential Loyalist,3
1888,88,4,5775.32,3,2,5,10,At Risk,1
1889,136,5,6210.6900000000005,2,3,6,11,At Risk,3
1890,45,9,10862.91,6,6,10,22,Loyal Customers,2
1891,82,7,9203.4,3,5,9,17,Potential Loyalist,3
1892,108,5,3113.52,2,3,2,7,Lost Customers,1
1893,3,7,7903.94,10,5,8,23,Loyal Customers,2
1894,37,4,3591.0299999999997,6,2,2,10,At Risk,0
1895,8,5,2110.2599999999998,10,3,1,14,At Risk,0
1896,160,3,3843.92,1,1,3,5,Lost Customers,1
1897,63,7,5120.75,4,5,5,14,At Risk,3
1898,61,6,7885.110000000001,5,4,8,17,Potential Loyalist,3
1899,77,5,3807.34,4,3,3,10,At Risk,1
1900,68,4,3327.94,4,2,2,8,Lost Customers,1
1901,128,7,10098.550000000001,2,5,10,17,Potential Loyalist,3
1902,53,5,5226.46,5,3,5,13,At Risk,3
1903,17,4,6548.94,8,2,6,16,Potential Loyalist,0
1904,68,3,1954.46,4,1,1,6,Lost Customers,1
1905,11,9,9595.46,9,6,9,24,Loyal Customers,2
1906,2,6,5992.34,10,4,6,20,Loyal Customers,0
1907,111,4,3740.6,2,2,3,7,Lost Customers,1
1908,108,6,7578.92,2,4,8,14,At Risk,3
1909,60,6,5543.2,5,4,5,14,At Risk,3
1910,18,3,3041.75,8,1,2,11,At Risk,0
1911,62,2,3156.3599999999997,4,1,2,7,Lost Customers,1
1912,39,9,7048.1900000000005,6,6,7,19,Potential Loyalist,2
1913,43,13,8621.87,6,7,9,22,Loyal Customers,2
1914,13,8,7833.69,9,6,8,23,Loyal Customers,2
1915,62,5,4749.41,4,3,4,11,At Risk,1
1916,54,7,7436.05,5,5,7,17,Potential Loyalist,3
1917,29,7,9783.66,7,5,9,21,Loyal Customers,2
1918,2,5,6735.74,10,3,7,20,Loyal Customers,2
1919,45,4,3935.23,6,2,3,11,At Risk,0
1920,70,1,360.4,4,1,1,6,Lost Customers,1
1921,41,1,586.45,6,1,1,8,Lost Customers,0
1922,94,3,3352.52,3,1,2,6,Lost Customers,1
1923,16,4,3704.94,8,2,3,13,At Risk,0
1924,26,3,4133.39,7,1,3,11,At Risk,0
1925,6,7,6617.74,10,5,7,22,Loyal Customers,2
1926,6,5,7762.71,10,3,8,21,Loyal Customers,2
1927,91,5,6439.16,3,3,6,12,At Risk,3
1928,35,2,2219.84,6,1,1,8,Lost Customers,0
1929,46,6,3442.2,6,4,2,12,At Risk,0
1930,22,5,6575.57,8,3,7,18,Potential Loyalist,2
1931,24,3,2218.5,8,1,1,10,At Risk,0
1932,90,8,12027.439999999999,3,6,10,19,Potential Loyalist,3
1933,42,8,10647.53,6,6,10,22,Loyal Customers,2
1934,4,6,6431.09,10,4,6,20,Loyal Customers,0
1935,58,6,6514.44,5,4,6,15,Potential Loyalist,3
1936,78,8,9673.2,4,6,9,19,Potential Loyalist,3
1937,35,6,8393.86,6,4,8,18,Potential Loyalist,3
1938,230,4,5966.86,1,2,6,9,Lost Customers,3
1939,77,2,806.18,4,1,1,6,Lost Customers,1
1940,77,4,6093.610000000001,4,2,6,12,At Risk,3
1941,6,4,4645.6900000000005,10,2,4,16,Potential Loyalist,0
1942,17,8,6241.37,8,6,6,20,Loyal Customers,2
1943,300,3,2075.7799999999997,1,1,1,3,Lost Customers,1
1944,6,5,5704.360000000001,10,3,5,18,Potential Loyalist,0
1945,116,3,2551.62,2,1,1,4,Lost Customers,1
1946,89,13,11237.380000000001,3,7,10,20,Loyal Customers,3
1947,36,9,8225.63,6,6,8,20,Loyal Customers,2
1948,169,5,4266.28,1,3,3,7,Lost Customers,1
1949,30,7,8547.61,7,5,9,21,Loyal Customers,2
1950,7,9,12108.45,10,6,10,26,Best Customers,2
1951,119,8,6977.969999999999,2,6,7,15,Potential Loyalist,3
1952,77,10,7870.0,4,7,8,19,Potential Loyalist,3
1953,11,7,6386.97,9,5,6,20,Loyal Customers,2
1954,101,8,9484.04,3,6,9,18,Potential Loyalist,3
1955,79,3,3235.83,3,1,2,6,Lost Customers,1
1956,34,4,3039.79,7,2,2,11,At Risk,0
1957,20,10,11536.57,8,7,10,25,Best Customers,2
1958,70,4,2389.99,4,2,1,7,Lost Customers,1
1959,142,8,7593.280000000001,2,6,8,16,Potential Loyalist,3
1960,70,3,4742.2,4,1,4,9,Lost Customers,1
1961,26,3,4600.360000000001,7,1,4,12,At Risk,0
1962,94,2,1385.6,3,1,1,5,Lost Customers,1
1963,10,2,2683.29,9,1,2,12,At Risk,0
1964,103,6,8039.19,3,4,8,15,Potential Loyalist,3
1965,7,5,4201.57,10,3,3,16,Potential Loyalist,0
1966,162,6,3660.46,1,4,3,8,Lost Customers,1
1967,23,5,6213.99,8,3,6,17,Potential Loyalist,0
1968,160,5,4664.66,1,3,4,8,Lost Customers,1
1969,18,6,6142.67,8,4,6,18,Potential Loyalist,0
1970,1,8,8590.23,10,6,9,25,Best Customers,2
1971,63,7,8998.88,4,5,9,18,Potential Loyalist,3
1972,1,4,4795.139999999999,10,2,4,16,Potential Loyalist,0
1973,48,4,4932.1,5,2,4,11,At Risk,1
1974,33,5,3780.45,7,3,3,13,At Risk,0
1975,109,2,661.42,2,1,1,4,Lost Customers,1
1976,136,6,6246.07,2,4,6,12,At Risk,3
1977,61,4,3681.98,5,2,3,10,At Risk,1
1978,153,2,1458.0,1,1,1,3,Lost Customers,1
1979,34,5,8062.73,7,3,8,18,Potential Loyalist,2
1980,74,8,9465.380000000001,4,6,9,19,Potential Loyalist,3
1981,90,3,4850.6900000000005,3,1,4,8,Lost Customers,1
1982,51,8,10897.34,5,6,10,21,Loyal Customers,3
1983,3,4,5795.41,10,2,5,17,Potential Loyalist,0
1984,49,7,10526.43,5,5,10,20,Loyal Customers,3
1985,1,7,7022.76,10,5,7,22,Loyal Customers,2
1986,45,6,4472.25,6,4,4,14,At Risk,0
1987,43,3,2490.23,6,1,1,8,Lost Customers,0
1988,135,8,10687.63,2,6,10,18,Potential Loyalist,3
1989,23,4,5139.46,8,2,5,15,Potential Loyalist,0
1990,11,7,6216.3,9,5,6,20,Loyal Customers,2
1991,2,10,12813.27,10,7,10,27,Best Customers,2
1992,141,10,14165.05,2,7,10,19,Potential Loyalist,3
1993,75,8,8421.95,4,6,8,18,Potential Loyalist,3
1994,3,6,7273.34,10,4,7,21,Loyal Customers,2
1995,126,6,5245.66,2,4,5,11,At Risk,3
1996,14,7,6300.450000000001,9,5,6,20,Loyal Customers,2
1997,55,5,4713.72,5,3,4,12,At Risk,0
1998,157,4,5359.34,1,2,5,8,Lost Customers,1
1999,4,7,8432.98,10,5,8,23,Loyal Customers,2
2000,45,3,2951.12,6,1,2,9,Lost Customers,0
2001,87,8,10016.79,3,6,9,18,Potential Loyalist,3
2002,98,3,2637.04,3,1,2,6,Lost Customers,1
2003,220,2,1821.05,1,1,1,3,Lost Customers,1
2004,47,5,6042.51,5,3,6,14,At Risk,3
2005,6,6,7337.82,10,4,7,21,Loyal Customers,2
2006,148,5,6192.77,1,3,6,10,At Risk,3
2007,24,3,5180.32,8,1,5,14,At Risk,0
2008,30,6,6546.94,7,4,6,17,Potential Loyalist,0
2009,6,7,7073.18,10,5,7,22,Loyal Customers,2
2010,35,5,5466.66,6,3,5,14,At Risk,0
2011,316,3,2057.82,1,1,1,3,Lost Customers,1
2012,14,5,5492.34,9,3,5,17,Potential Loyalist,0
2013,16,8,7815.47,8,6,8,22,Loyal Customers,2
2014,55,6,5544.87,5,4,5,14,At Risk,3
2015,51,6,7253.27,5,4,7,16,Potential Loyalist,3
2016,69,6,5897.56,4,4,6,14,At Risk,3
2017,13,5,5612.86,9,3,5,17,Potential Loyalist,0
2018,36,7,7597.12,6,5,8,19,Potential Loyalist,2
2019,53,8,9082.849999999999,5,6,9,20,Loyal Customers,3
2020,44,7,8810.74,6,5,9,20,Loyal Customers,2
2021,126,2,802.88,2,1,1,4,Lost Customers,1
2022,14,5,5843.24,9,3,6,18,Potential Loyalist,0
2023,14,10,10149.33,9,7,10,26,Best Customers,2
2024,30,6,5998.77,7,4,6,17,Potential Loyalist,0
2025,139,4,4120.88,2,2,3,7,Lost Customers,1
2026,147,4,6109.3,2,2,6,10,At Risk,3
2027,15,7,6353.8099999999995,9,5,6,20,Loyal Customers,2
2028,41,7,7274.75,6,5,7,18,Potential Loyalist,3
2029,2,9,6555.91,10,6,7,23,Loyal Customers,2
2030,240,4,6169.62,1,2,6,9,Lost Customers,3
2031,20,4,4477.1900000000005,8,2,4,14,At Risk,0
2032,6,2,1640.3,10,1,1,12,At Risk,0
2033,12,7,10152.52,9,5,10,24,Loyal Customers,2
2034,90,6,6954.37,3,4,7,14,At Risk,3
2035,128,3,2797.16,2,1,2,5,Lost Customers,1
2036,26,12,10761.29,7,7,10,24,Loyal Customers,2
2037,99,4,4403.780000000001,3,2,3,8,Lost Customers,1
2038,14,4,4230.27,9,2,3,14,At Risk,0
2039,200,4,4532.55,1,2,4,7,Lost Customers,1
2040,97,2,3028.8900000000003,3,1,2,6,Lost Customers,1
2041,81,6,7729.64,3,4,8,15,Potential Loyalist,3
2042,12,3,4170.51,9,1,3,13,At Risk,0
2043,140,5,6704.41,2,3,7,12,At Risk,3
2044,6,5,7468.57,10,3,8,21,Loyal Customers,2
2045,56,8,7477.2300000000005,5,6,8,19,Potential Loyalist,3
2046,34,9,13347.529999999999,7,6,10,23,Loyal Customers,2
2047,280,1,1289.85,1,1,1,3,Lost Customers,1
2048,58,6,8276.52,5,4,8,17,Potential Loyalist,3
2049,77,5,5513.37,4,3,5,12,At Risk,3
2050,7,4,4483.5,10,2,4,16,Potential Loyalist,0
2051,52,6,7376.93,5,4,7,16,Potential Loyalist,3
2052,59,9,7052.08,5,6,7,18,Potential Loyalist,3
2053,6,6,7727.0,10,4,8,22,Loyal Customers,2
2054,2,4,5248.59,10,2,5,17,Potential Loyalist,0
2055,1,9,12172.04,10,6,10,26,Best Customers,2
2056,55,2,1829.4899999999998,5,1,1,7,Lost Customers,1
2057,17,6,6889.26,8,4,7,19,Potential Loyalist,2
2058,121,7,7546.98,2,5,8,15,Potential Loyalist,3
2059,171,4,2702.14,1,2,2,5,Lost Customers,1
2060,6,11,11179.22,10,7,10,27,Best Customers,2
2061,133,6,8403.650000000001,2,4,8,14,At Risk,3
2062,43,5,6976.84,6,3,7,16,Potential Loyalist,3
2063,10,5,4125.82,9,3,3,15,Potential Loyalist,0
2064,107,5,5871.14,2,3,6,11,At Risk,3
2065,216,4,4870.0599999999995,1,2,4,7,Lost Customers,1
2066,91,5,6115.09,3,3,6,12,At Risk,3
2067,31,8,9622.05,7,6,9,22,Loyal Customers,2
2068,160,5,5158.92,1,3,5,9,Lost Customers,1
2069,52,6,10361.07,5,4,10,19,Potential Loyalist,3
2070,5,8,10228.07,10,6,10,26,Best Customers,2
2071,21,7,5340.02,8,5,5,18,Potential Loyalist,0
2072,9,13,11845.439999999999,9,7,10,26,Best Customers,2
2073,57,6,6343.110000000001,5,4,6,15,Potential Loyalist,3
2075,5,4,5575.41,10,2,5,17,Potential Loyalist,0
2076,20,8,12082.72,8,6,10,24,Loyal Customers,2
2077,228,3,4642.2,1,1,4,6,Lost Customers,1
2078,66,5,5509.86,4,3,5,12,At Risk,3
2079,4,3,4631.31,10,1,4,15,Potential Loyalist,0
2080,163,6,6668.6,1,4,7,12,At Risk,3
2081,12,5,5586.19,9,3,5,17,Potential Loyalist,0
2082,2,7,6778.84,10,5,7,22,Loyal Customers,2
2083,16,9,10347.279999999999,8,6,10,24,Loyal Customers,2
2084,120,2,1415.51,2,1,1,4,Lost Customers,1
2085,28,3,4294.14,7,1,3,11,At Risk,0
2086,99,3,3812.2200000000003,3,1,3,7,Lost Customers,1
2087,56,5,6577.63,5,3,7,15,Potential Loyalist,3
2088,10,6,8158.3,9,4,8,21,Loyal Customers,2
2089,148,2,477.32000000000005,1,1,1,3,Lost Customers,1
2090,164,2,1020.78,1,1,1,3,Lost Customers,1
2091,212,3,5499.04,1,1,5,7,Lost Customers,1
2092,17,5,6764.39,8,3,7,18,Potential Loyalist,2
2093,61,6,7654.84,5,4,8,17,Potential Loyalist,3
2094,35,5,4214.53,6,3,3,12,At Risk,0
2095,21,10,9988.76,8,7,9,24,Loyal Customers,2
2096,133,5,8229.84,2,3,8,13,At Risk,3
2097,39,6,7726.09,6,4,8,18,Potential Loyalist,3
2098,9,6,5472.62,9,4,5,18,Potential Loyalist,0
2099,64,7,8967.04,4,5,9,18,Potential Loyalist,3
2100,19,5,4288.18,8,3,3,14,At Risk,0
2101,21,9,12331.86,8,6,10,24,Loyal Customers,2
2102,18,7,7317.46,8,5,7,20,Loyal Customers,2
2103,15,10,11617.25,9,7,10,26,Best Customers,2
2104,81,8,7415.84,3,6,7,16,Potential Loyalist,3
2105,24,5,7196.7699999999995,8,3,7,18,Potential Loyalist,2
2106,4,4,6782.28,10,2,7,19,Potential Loyalist,0
2107,65,2,1941.0,4,1,1,6,Lost Customers,1
2108,13,3,3130.2599999999998,9,1,2,12,At Risk,0
2109,3,8,7637.12,10,6,8,24,Loyal Customers,2
2110,27,6,6518.34,7,4,6,17,Potential Loyalist,0
2111,7,9,11111.3,10,6,10,26,Best Customers,2
2112,3,4,5958.110000000001,10,2,6,18,Potential Loyalist,0
2113,34,4,4987.47,7,2,4,13,At Risk,0
2114,15,6,6706.46,9,4,7,20,Loyal Customers,2
2115,48,2,2204.45,5,1,1,7,Lost Customers,1
2116,106,4,5827.96,2,2,5,9,Lost Customers,1
2117,25,5,3925.17,7,3,3,13,At Risk,0
2118,136,6,6724.4,2,4,7,13,At Risk,3
2119,68,4,5477.6,4,2,5,11,At Risk,1
2120,3,8,11028.33,10,6,10,26,Best Customers,2
2121,90,9,10142.52,3,6,10,19,Potential Loyalist,3
2122,9,2,1275.53,9,1,1,11,At Risk,0
2123,196,6,6196.02,1,4,6,11,At Risk,3
2124,58,6,7618.68,5,4,8,17,Potential Loyalist,3
2125,14,6,4206.48,9,4,3,16,Potential Loyalist,0
2126,26,4,2963.04,7,2,2,11,At Risk,0
2127,33,5,5437.05,7,3,5,15,Potential Loyalist,0
2128,14,2,3787.46,9,1,3,13,At Risk,0
2129,150,2,1411.9299999999998,1,1,1,3,Lost Customers,1
2130,2,8,9169.4,10,6,9,25,Best Customers,2
2131,102,5,5423.23,3,3,5,11,At Risk,3
2132,19,8,12668.24,8,6,10,24,Loyal Customers,2
2133,121,5,6553.44,2,3,7,12,At Risk,3
2134,82,5,6556.68,3,3,7,13,At Risk,3
2135,339,1,1977.36,1,1,1,3,Lost Customers,1
2136,11,4,6269.92,9,2,6,17,Potential Loyalist,0
2137,21,4,4683.41,8,2,4,14,At Risk,0
2138,44,7,9725.78,6,5,9,20,Loyal Customers,2
2139,61,5,7480.94,5,3,8,16,Potential Loyalist,3
2140,99,8,9047.439999999999,3,6,9,18,Potential Loyalist,3
2141,77,4,4820.85,4,2,4,10,At Risk,1
2142,82,7,10200.02,3,5,10,18,Potential Loyalist,3
2143,28,4,5641.38,7,2,5,14,At Risk,0
2144,68,8,10452.24,4,6,10,20,Loyal Customers,3
2145,195,1,748.17,1,1,1,3,Lost Customers,1
2146,51,2,2173.1099999999997,5,1,1,7,Lost Customers,1
2147,126,3,2953.18,2,1,2,5,Lost Customers,1
2148,138,4,4907.04,2,2,4,8,Lost Customers,1
2149,12,8,5293.03,9,6,5,20,Loyal Customers,2
2150,95,6,6161.6,3,4,6,13,At Risk,3
2151,147,6,9138.82,2,4,9,15,Potential Loyalist,3
2152,2,9,9894.84,10,6,9,25,Best Customers,2
2153,77,7,7792.47,4,5,8,17,Potential Loyalist,3
2154,39,6,7924.87,6,4,8,18,Potential Loyalist,3
2155,20,11,8886.39,8,7,9,24,Loyal Customers,2
2156,114,6,6988.71,2,4,7,13,At Risk,3
2157,162,2,2131.52,1,1,1,3,Lost Customers,1
2158,51,5,5982.3,5,3,6,14,At Risk,3
2159,19,5,5111.04,8,3,5,16,Potential Loyalist,0
2160,48,6,6852.88,5,4,7,16,Potential Loyalist,3
2161,53,5,5998.47,5,3,6,14,At Risk,3
2162,54,4,4785.389999999999,5,2,4,11,At Risk,1
2163,71,4,3236.7,4,2,2,8,Lost Customers,1
2164,69,7,8585.81,4,5,9,18,Potential Loyalist,3
2165,1,10,9072.94,10,7,9,26,Best Customers,2
2166,59,6,6021.83,5,4,6,15,Potential Loyalist,3
2167,145,6,4691.02,2,4,4,10,At Risk,1
2168,3,3,3828.1,10,1,3,14,At Risk,0
2169,118,5,8555.14,2,3,9,14,At Risk,3
2170,29,6,7695.75,7,4,8,19,Potential Loyalist,2
2171,35,6,4500.04,6,4,4,14,At Risk,0
2172,30,4,6844.5,7,2,7,16,Potential Loyalist,0
2173,158,4,5112.15,1,2,5,8,Lost Customers,1
2174,82,5,6589.83,3,3,7,13,At Risk,3
2175,59,4,4158.65,5,2,3,10,At Risk,1
2176,29,3,2662.8199999999997,7,1,2,10,At Risk,0
2177,99,5,6054.27,3,3,6,12,At Risk,3
2178,78,4,3531.64,4,2,2,8,Lost Customers,1
2179,37,7,6889.21,6,5,7,18,Potential Loyalist,3
2180,81,5,6162.33,3,3,6,12,At Risk,3
2181,52,8,6274.12,5,6,6,17,Potential Loyalist,3
2182,18,8,10722.16,8,6,10,24,Loyal Customers,2
2183,9,14,19071.32,9,7,10,26,Best Customers,2
2184,38,11,13468.26,6,7,10,23,Loyal Customers,2
2185,137,7,9578.97,2,5,9,16,Potential Loyalist,3
2186,155,3,4245.21,1,1,3,5,Lost Customers,1
2187,64,7,8284.37,4,5,8,17,Potential Loyalist,3
2188,71,6,6671.540000000001,4,4,7,15,Potential Loyalist,3
2189,41,10,9861.3,6,7,9,22,Loyal Customers,2
2190,42,8,11980.720000000001,6,6,10,22,Loyal Customers,2
2191,13,4,5941.41,9,2,6,17,Potential Loyalist,0
2192,43,4,2098.19,6,2,1,9,Lost Customers,0
2193,55,4,6086.66,5,2,6,13,At Risk,3
2194,43,8,8464.84,6,6,8,20,Loyal Customers,2
2195,3,5,7266.610000000001,10,3,7,20,Loyal Customers,2
2196,72,5,4425.25,4,3,4,11,At Risk,1
2197,120,3,2284.5600000000004,2,1,1,4,Lost Customers,1
2198,26,3,2366.21,7,1,1,9,Lost Customers,0
2199,25,4,4628.71,7,2,4,13,At Risk,0
2200,255,1,980.37,1,1,1,3,Lost Customers,1
2201,31,7,10466.46,7,5,10,22,Loyal Customers,2
2202,59,9,8331.17,5,6,8,19,Potential Loyalist,3
2203,50,5,6421.1,5,3,6,14,At Risk,3
2204,18,8,7935.08,8,6,8,22,Loyal Customers,2
2205,101,3,3872.62,3,1,3,7,Lost Customers,1
2206,59,4,4155.32,5,2,3,10,At Risk,1
2207,75,6,6263.82,4,4,6,14,At Risk,3
2208,115,6,5236.3099999999995,2,4,5,11,At Risk,3
2209,266,1,1240.31,1,1,1,3,Lost Customers,1
2210,28,9,8133.83,7,6,8,21,Loyal Customers,2
2211,112,3,1649.1599999999999,2,1,1,4,Lost Customers,1
2212,42,6,4951.08,6,4,4,14,At Risk,0
2213,16,5,7240.5,8,3,7,18,Potential Loyalist,2
2214,28,5,5053.05,7,3,4,14,At Risk,0
2215,20,2,1965.6799999999998,8,1,1,10,At Risk,0
2216,75,3,3352.32,4,1,2,7,Lost Customers,1
2217,23,7,6891.28,8,5,7,20,Loyal Customers,2
2218,22,3,4304.09,8,1,3,12,At Risk,0
2219,62,5,6319.34,4,3,6,13,At Risk,3
2220,86,4,4529.9,3,2,4,9,Lost Customers,1
2221,95,8,9100.52,3,6,9,18,Potential Loyalist,3
2222,60,6,7051.67,5,4,7,16,Potential Loyalist,3
2223,55,7,5883.75,5,5,6,16,Potential Loyalist,3
2224,288,3,2568.2200000000003,1,1,1,3,Lost Customers,1
2225,209,3,5546.31,1,1,5,7,Lost Customers,1
2226,50,8,8295.55,5,6,8,19,Potential Loyalist,3
2227,41,5,5068.82,6,3,4,13,At Risk,0
2228,169,4,3579.45,1,2,2,5,Lost Customers,1
2229,22,4,3937.92,8,2,3,13,At Risk,0
2230,66,7,9308.57,4,5,9,18,Potential Loyalist,3
2231,65,3,4555.37,4,1,4,9,Lost Customers,1
2232,60,6,5666.030000000001,5,4,5,14,At Risk,3
2233,64,7,6778.26,4,5,7,16,Potential Loyalist,3
2234,155,5,2525.05,1,3,1,5,Lost Customers,1
2235,81,6,7834.27,3,4,8,15,Potential Loyalist,3
2236,2,3,4226.47,10,1,3,14,At Risk,0
2237,39,7,7412.94,6,5,7,18,Potential Loyalist,3
2238,142,3,4185.99,2,1,3,6,Lost Customers,1
2239,33,2,1693.21,7,1,1,9,Lost Customers,0
2240,32,12,13961.45,7,7,10,24,Loyal Customers,2
2241,18,4,4335.0,8,2,3,13,At Risk,0
2242,171,3,2540.1099999999997,1,1,1,3,Lost Customers,1
2243,184,3,2141.05,1,1,1,3,Lost Customers,1
2244,64,5,5963.92,4,3,6,13,At Risk,3
2245,75,7,7779.9,4,5,8,17,Potential Loyalist,3
2246,100,4,4027.99,3,2,3,8,Lost Customers,1
2247,30,7,8149.4800000000005,7,5,8,20,Loyal Customers,2
2248,52,8,8369.31,5,6,8,19,Potential Loyalist,3
2249,113,5,5600.46,2,3,5,10,At Risk,1
2250,125,3,3011.79,2,1,2,5,Lost Customers,1
2251,16,7,5798.71,8,5,5,18,Potential Loyalist,0
2252,131,4,4900.68,2,2,4,8,Lost Customers,1
2253,85,5,6843.67,3,3,7,13,At Risk,3
2254,4,5,5373.7,10,3,5,18,Potential Loyalist,0
2255,144,2,3277.4700000000003,2,1,2,5,Lost Customers,1
2256,170,3,4499.85,1,1,4,6,Lost Customers,1
2257,65,5,6440.81,4,3,6,13,At Risk,3
2258,53,6,7710.9,5,4,8,17,Potential Loyalist,3
2259,162,4,4205.21,1,2,3,6,Lost Customers,1
2260,18,6,8234.9,8,4,8,20,Loyal Customers,2
2261,36,4,3875.61,6,2,3,11,At Risk,0
2262,76,4,3058.55,4,2,2,8,Lost Customers,1
2263,36,5,6359.93,6,3,6,15,Potential Loyalist,0
2264,154,6,5198.18,1,4,5,10,At Risk,3
2265,96,3,3990.7799999999997,3,1,3,7,Lost Customers,1
2266,30,10,8911.6,7,7,9,23,Loyal Customers,2
2267,100,5,5466.639999999999,3,3,5,11,At Risk,3
2268,36,8,9258.43,6,6,9,21,Loyal Customers,2
2269,48,7,9233.33,5,5,9,19,Potential Loyalist,3
2270,130,5,7588.29,2,3,8,13,At Risk,3
2271,178,1,1362.99,1,1,1,3,Lost Customers,1
2272,105,6,8116.8,2,4,8,14,At Risk,3
2273,27,10,9867.35,7,7,9,23,Loyal Customers,2
2274,56,2,142.98,5,1,1,7,Lost Customers,1
2275,122,6,8289.0,2,4,8,14,At Risk,3
2276,11,4,4714.45,9,2,4,15,Potential Loyalist,0
2277,37,4,4721.53,6,2,4,12,At Risk,0
2278,35,4,1635.2399999999998,6,2,1,9,Lost Customers,0
2279,36,8,7565.7,6,6,8,20,Loyal Customers,2
2280,25,5,6373.32,7,3,6,16,Potential Loyalist,0
2281,39,6,6617.76,6,4,7,17,Potential Loyalist,3
2282,15,6,6818.610000000001,9,4,7,20,Loyal Customers,2
2283,31,7,7052.93,7,5,7,19,Potential Loyalist,2
2284,35,7,7556.9400000000005,6,5,8,19,Potential Loyalist,2
2285,40,7,4829.54,6,5,4,15,Potential Loyalist,0
2286,50,5,4606.01,5,3,4,12,At Risk,0
2287,160,2,1083.52,1,1,1,3,Lost Customers,1
2288,30,6,6972.7,7,4,7,18,Potential Loyalist,2
2289,60,4,4560.12,5,2,4,11,At Risk,1
2290,73,5,5602.610000000001,4,3,5,12,At Risk,3
2291,108,1,792.9,2,1,1,4,Lost Customers,1
2292,46,7,8732.619999999999,6,5,9,20,Loyal Customers,2
2293,86,5,5018.52,3,3,4,10,At Risk,1
2294,74,7,9680.22,4,5,9,18,Potential Loyalist,3
2295,18,4,5830.14,8,2,6,16,Potential Loyalist,0
2296,37,4,5259.05,6,2,5,13,At Risk,0
2297,38,5,6232.6900000000005,6,3,6,15,Potential Loyalist,0
2298,46,5,4992.1900000000005,6,3,4,13,At Risk,0
2299,60,6,4359.32,5,4,3,12,At Risk,0
2300,18,4,7346.110000000001,8,2,7,17,Potential Loyalist,0
2301,6,5,8675.69,10,3,9,22,Loyal Customers,2
2302,54,3,4412.84,5,1,3,9,Lost Customers,1
2303,145,2,2696.8599999999997,2,1,2,5,Lost Customers,1
2304,4,7,9747.9,10,5,9,24,Loyal Customers,2
2305,79,4,4233.89,3,2,3,8,Lost Customers,1
2306,7,4,4938.639999999999,10,2,4,16,Potential Loyalist,0
2307,82,11,10123.71,3,7,10,20,Loyal Customers,3
2308,14,9,11438.369999999999,9,6,10,25,Best Customers,2
2309,54,12,16122.34,5,7,10,22,Loyal Customers,2
2310,16,6,8126.88,8,4,8,20,Loyal Customers,2
2311,67,5,6375.870000000001,4,3,6,13,At Risk,3
2312,42,4,5159.04,6,2,5,13,At Risk,0
2313,45,6,4657.8,6,4,4,14,At Risk,0
2314,49,3,4114.37,5,1,3,9,Lost Customers,1
2315,153,5,2737.7999999999997,1,3,2,6,Lost Customers,1
2316,47,4,2908.85,5,2,2,9,Lost Customers,1
2317,54,5,6735.95,5,3,7,15,Potential Loyalist,3
2318,17,7,8129.61,8,5,8,21,Loyal Customers,2
2319,10,4,7191.200000000001,9,2,7,18,Potential Loyalist,0
2320,25,3,2655.46,7,1,2,10,At Risk,0
2321,162,3,5473.58,1,1,5,7,Lost Customers,1
2322,68,4,4035.5099999999998,4,2,3,9,Lost Customers,1
2323,213,3,4599.45,1,1,4,6,Lost Customers,1
2324,79,4,4867.58,3,2,4,9,Lost Customers,1
2325,122,5,6019.48,2,3,6,11,At Risk,3
2326,113,1,774.53,2,1,1,4,Lost Customers,1
2327,225,3,4153.110000000001,1,1,3,5,Lost Customers,1
2328,152,1,441.49,1,1,1,3,Lost Customers,1
2329,9,5,4252.36,9,3,3,15,Potential Loyalist,0
2330,5,3,2391.06,10,1,1,12,At Risk,0
2331,20,7,5341.04,8,5,5,18,Potential Loyalist,0
2332,32,4,1972.9,7,2,1,10,At Risk,0
2333,93,4,5216.82,3,2,5,10,At Risk,1
2334,70,3,3616.74,4,1,2,7,Lost Customers,1
2335,12,7,7350.46,9,5,7,21,Loyal Customers,2
2336,75,9,10942.55,4,6,10,20,Loyal Customers,3
2337,173,3,2169.36,1,1,1,3,Lost Customers,1
2338,24,7,7546.18,8,5,8,21,Loyal Customers,2
2339,26,7,7321.5,7,5,7,19,Potential Loyalist,2
2340,6,9,9442.23,10,6,9,25,Best Customers,2
2341,14,7,9978.130000000001,9,5,9,23,Loyal Customers,2
2342,66,2,2849.0299999999997,4,1,2,7,Lost Customers,1
2343,63,3,4215.4,4,1,3,8,Lost Customers,1
2344,48,6,6947.3,5,4,7,16,Potential Loyalist,3
2345,1,4,6939.88,10,2,7,19,Potential Loyalist,0
2346,163,5,6429.33,1,3,6,10,At Risk,3
2347,88,9,10730.51,3,6,10,19,Potential Loyalist,3
2348,61,4,2451.77,5,2,1,8,Lost Customers,1
2349,55,5,3608.1400000000003,5,3,2,10,At Risk,1
2350,181,4,3747.5,1,2,3,6,Lost Customers,1
2351,56,7,6531.82,5,5,6,16,Potential Loyalist,3
2352,37,1,1292.84,6,1,1,8,Lost Customers,0
2353,82,10,11013.74,3,7,10,20,Loyal Customers,3
2354,37,5,4817.55,6,3,4,13,At Risk,0
2355,71,5,5619.5599999999995,4,3,5,12,At Risk,3
2356,147,4,5020.27,2,2,4,8,Lost Customers,1
2357,41,4,5811.12,6,2,5,13,At Risk,0
2358,4,11,8523.43,10,7,8,25,Best Customers,2
2359,83,8,9029.74,3,6,9,18,Potential Loyalist,3
2360,28,6,8601.41,7,4,9,20,Loyal Customers,2
2361,23,7,7640.51,8,5,8,21,Loyal Customers,2
2362,46,3,3007.23,6,1,2,9,Lost Customers,0
2363,59,6,5473.37,5,4,5,14,At Risk,3
2364,44,5,8404.81,6,3,8,17,Potential Loyalist,3
2365,2,5,5448.58,10,3,5,18,Potential Loyalist,0
2366,20,5,5543.95,8,3,5,16,Potential Loyalist,0
2367,26,6,7931.35,7,4,8,19,Potential Loyalist,2
2368,75,6,7617.099999999999,4,4,8,16,Potential Loyalist,3
2369,2,8,11223.94,10,6,10,26,Best Customers,2
2370,21,3,3107.9700000000003,8,1,2,11,At Risk,0
2371,94,5,7720.1,3,3,8,14,At Risk,3
2372,1,8,8067.12,10,6,8,24,Loyal Customers,2
2373,46,4,4758.4400000000005,6,2,4,12,At Risk,0
2374,15,7,7495.68,9,5,8,22,Loyal Customers,2
2375,44,7,9972.86,6,5,9,20,Loyal Customers,2
2376,12,3,3621.9700000000003,9,1,2,12,At Risk,0
2377,8,5,8081.98,10,3,8,21,Loyal Customers,2
2378,11,5,5040.639999999999,9,3,4,16,Potential Loyalist,0
2379,4,11,13030.07,10,7,10,27,Best Customers,2
2380,43,6,6658.59,6,4,7,17,Potential Loyalist,3
2381,30,7,7877.93,7,5,8,20,Loyal Customers,2
2382,39,7,3369.77,6,5,2,13,At Risk,0
2383,22,9,13104.08,8,6,10,24,Loyal Customers,2
2384,60,6,5845.17,5,4,6,15,Potential Loyalist,3
2385,32,8,7901.9400000000005,7,6,8,21,Loyal Customers,2
2386,13,7,7710.12,9,5,8,22,Loyal Customers,2
2387,183,2,591.31,1,1,1,3,Lost Customers,1
2388,114,7,10013.26,2,5,9,16,Potential Loyalist,3
2389,9,3,2456.1800000000003,9,1,1,11,At Risk,0
2390,70,6,8204.630000000001,4,4,8,16,Potential Loyalist,3
2391,13,9,9000.68,9,6,9,24,Loyal Customers,2
2392,27,5,5215.18,7,3,5,15,Potential Loyalist,0
2393,123,2,1228.76,2,1,1,4,Lost Customers,1
2394,91,1,980.37,3,1,1,5,Lost Customers,1
2395,63,1,230.91,4,1,1,6,Lost Customers,1
2396,1,4,4326.13,10,2,3,15,Potential Loyalist,0
2397,54,9,10464.01,5,6,10,21,Loyal Customers,3
2398,114,3,2426.93,2,1,1,4,Lost Customers,1
2399,39,6,6424.44,6,4,6,16,Potential Loyalist,3
2400,20,8,10452.28,8,6,10,24,Loyal Customers,2
2401,22,8,10935.93,8,6,10,24,Loyal Customers,2
2402,79,3,4490.75,3,1,4,8,Lost Customers,1
2403,151,4,2707.12,1,2,2,5,Lost Customers,1
2404,188,5,7607.2,1,3,8,12,At Risk,3
2405,46,5,2817.81,6,3,2,11,At Risk,0
2406,81,4,4117.37,3,2,3,8,Lost Customers,1
2407,69,5,5107.530000000001,4,3,5,12,At Risk,3
2408,25,3,3920.17,7,1,3,11,At Risk,0
2409,50,7,7117.35,5,5,7,17,Potential Loyalist,3
2410,37,6,6772.02,6,4,7,17,Potential Loyalist,3
2411,224,4,6535.39,1,2,6,9,Lost Customers,3
2412,18,6,7097.639999999999,8,4,7,19,Potential Loyalist,2
2413,59,7,8666.869999999999,5,5,9,19,Potential Loyalist,3
2414,5,3,4553.33,10,1,4,15,Potential Loyalist,0
2415,44,5,4412.09,6,3,3,12,At Risk,0
2416,223,2,2220.23,1,1,1,3,Lost Customers,1
2417,23,1,1129.13,8,1,1,10,At Risk,0
2418,3,7,9068.28,10,5,9,24,Loyal Customers,2
2419,52,8,8651.87,5,6,9,20,Loyal Customers,3
2420,140,3,2367.71,2,1,1,4,Lost Customers,1
2421,1,6,2836.38,10,4,2,16,Potential Loyalist,0
2422,33,5,4670.18,7,3,4,14,At Risk,0
2423,60,1,202.62,5,1,1,7,Lost Customers,1
2424,68,6,5579.95,4,4,5,13,At Risk,3
2425,9,9,8310.5,9,6,8,23,Loyal Customers,2
2426,17,5,8399.89,8,3,8,19,Potential Loyalist,2
2427,4,6,7962.36,10,4,8,22,Loyal Customers,2
2428,38,8,9038.36,6,6,9,21,Loyal Customers,2
2429,223,3,3811.29,1,1,3,5,Lost Customers,1
2430,116,4,3385.21,2,2,2,6,Lost Customers,1
2431,219,2,1447.1799999999998,1,1,1,3,Lost Customers,1
2432,41,5,3930.31,6,3,3,12,At Risk,0
2433,27,10,10945.11,7,7,10,24,Loyal Customers,2
2434,1,9,10024.41,10,6,9,25,Best Customers,2
2435,124,5,6950.49,2,3,7,12,At Risk,3
2436,17,4,3919.84,8,2,3,13,At Risk,0
2437,199,2,1436.8,1,1,1,3,Lost Customers,1
2438,28,7,6007.49,7,5,6,18,Potential Loyalist,2
2439,19,6,5841.8,8,4,6,18,Potential Loyalist,0
2440,54,3,4414.99,5,1,4,10,At Risk,1
2441,29,2,2059.61,7,1,1,9,Lost Customers,0
2442,81,6,5014.139999999999,3,4,4,11,At Risk,1
2443,13,6,6182.68,9,4,6,19,Potential Loyalist,0
2444,45,4,5166.36,6,2,5,13,At Risk,0
2445,18,5,5245.21,8,3,5,16,Potential Loyalist,0
2446,72,7,9602.64,4,5,9,18,Potential Loyalist,3
2447,40,7,7729.64,6,5,8,19,Potential Loyalist,2
2448,7,6,5418.88,10,4,5,19,Potential Loyalist,0
2449,77,5,6836.96,4,3,7,14,At Risk,3
2450,41,2,3861.74,6,1,3,10,At Risk,0
2451,18,3,3247.8500000000004,8,1,2,11,At Risk,0
2452,10,4,4209.71,9,2,3,14,At Risk,0
2453,57,6,4683.469999999999,5,4,4,13,At Risk,0
2454,30,10,11477.22,7,7,10,24,Loyal Customers,2
2455,76,8,8482.92,4,6,8,18,Potential Loyalist,3
2456,168,5,5167.12,1,3,5,9,Lost Customers,1
2457,53,6,8023.24,5,4,8,17,Potential Loyalist,3
2458,5,7,11224.23,10,5,10,25,Best Customers,2
2459,54,11,11877.19,5,7,10,22,Loyal Customers,2
2460,51,4,4291.639999999999,5,2,3,10,At Risk,1
2461,32,6,4090.26,7,4,3,14,At Risk,0
2462,25,5,5679.63,7,3,5,15,Potential Loyalist,0
2463,65,8,9906.89,4,6,9,19,Potential Loyalist,3
2464,3,13,14574.06,10,7,10,27,Best Customers,2
2465,12,9,9114.460000000001,9,6,9,24,Loyal Customers,2
2466,20,5,4796.14,8,3,4,15,Potential Loyalist,0
2467,22,5,2590.13,8,3,1,12,At Risk,0
2468,22,9,11893.32,8,6,10,24,Loyal Customers,2
2469,21,7,10397.56,8,5,10,23,Loyal Customers,2
2470,13,4,3356.1,9,2,2,13,At Risk,0
2471,14,5,5699.45,9,3,5,17,Potential Loyalist,0
2472,86,6,7612.35,3,4,8,15,Potential Loyalist,3
2473,114,5,4256.68,2,3,3,8,Lost Customers,1
2474,65,7,7884.070000000001,4,5,8,17,Potential Loyalist,3
2475,86,7,10009.91,3,5,9,17,Potential Loyalist,3
2476,15,14,14578.69,9,7,10,26,Best Customers,2
2477,41,1,2005.66,6,1,1,8,Lost Customers,0
2478,115,6,4323.68,2,4,3,9,Lost Customers,1
2479,3,6,2933.17,10,4,2,16,Potential Loyalist,0
2480,43,5,6781.5,6,3,7,16,Potential Loyalist,3
2481,21,7,5825.4,8,5,5,18,Potential Loyalist,0
2482,233,3,3110.6899999999996,1,1,2,4,Lost Customers,1
2483,70,4,2791.31,4,2,2,8,Lost Customers,1
2484,25,5,5401.62,7,3,5,15,Potential Loyalist,0
2485,5,5,4974.84,10,3,4,17,Potential Loyalist,0
2486,230,2,3246.42,1,1,2,4,Lost Customers,1
2487,99,4,2978.64,3,2,2,7,Lost Customers,1
2488,19,6,6900.389999999999,8,4,7,19,Potential Loyalist,2
2489,41,8,11411.16,6,6,10,22,Loyal Customers,2
2490,85,4,6095.51,3,2,6,11,At Risk,3
2491,106,5,3045.56,2,3,2,7,Lost Customers,1
2492,8,10,12661.35,10,7,10,27,Best Customers,2
2493,55,3,3796.09,5,1,3,9,Lost Customers,1
2494,96,6,5949.05,3,4,6,13,At Risk,3
2495,32,8,5497.11,7,6,5,18,Potential Loyalist,0
2496,197,5,2095.52,1,3,1,5,Lost Customers,1
2497,47,4,4265.4400000000005,5,2,3,10,At Risk,1
2498,8,8,9981.91,10,6,9,25,Best Customers,2
2499,176,3,3848.07,1,1,3,5,Lost Customers,1
2500,24,3,2535.87,8,1,1,10,At Risk,0
2501,19,7,7685.12,8,5,8,21,Loyal Customers,2
2502,15,5,4196.26,9,3,3,15,Potential Loyalist,0
2503,109,4,4951.0,2,2,4,8,Lost Customers,1
2504,94,5,5458.179999999999,3,3,5,11,At Risk,3
2505,13,9,10295.31,9,6,10,25,Best Customers,2
2506,107,4,5594.41,2,2,5,9,Lost Customers,1
2507,48,4,5405.0,5,2,5,12,At Risk,0
2508,57,10,12948.97,5,7,10,22,Loyal Customers,2
2509,26,8,8313.9,7,6,8,21,Loyal Customers,2
2510,112,6,8315.039999999999,2,4,8,14,At Risk,3
2511,33,4,5381.19,7,2,5,14,At Risk,0
2512,112,6,5536.07,2,4,5,11,At Risk,3
2513,107,7,8203.29,2,5,8,15,Potential Loyalist,3
2514,47,3,4414.05,5,1,4,10,At Risk,1
2515,25,3,4764.52,7,1,4,12,At Risk,0
2516,84,3,1978.9299999999998,3,1,1,5,Lost Customers,1
2517,146,3,4813.4,2,1,4,7,Lost Customers,1
2518,71,5,7538.469999999999,4,3,8,15,Potential Loyalist,3
2519,109,4,2487.22,2,2,1,5,Lost Customers,1
2520,12,5,4496.29,9,3,4,16,Potential Loyalist,0
2521,209,3,3422.3,1,1,2,4,Lost Customers,1
2522,25,6,7043.07,7,4,7,18,Potential Loyalist,2
2523,15,9,8492.78,9,6,8,23,Loyal Customers,2
2524,185,6,4384.97,1,4,3,8,Lost Customers,1
2525,304,1,1977.36,1,1,1,3,Lost Customers,1
2526,54,6,6039.110000000001,5,4,6,15,Potential Loyalist,3
2527,41,7,8751.73,6,5,9,20,Loyal Customers,2
2528,26,7,9485.91,7,5,9,21,Loyal Customers,2
2529,99,7,9000.92,3,5,9,17,Potential Loyalist,3
2530,10,6,3794.98,9,4,3,16,Potential Loyalist,0
2531,6,7,7233.38,10,5,7,22,Loyal Customers,2
2532,141,1,71.49,2,1,1,4,Lost Customers,1
2533,19,3,4689.75,8,1,4,13,At Risk,0
2534,46,7,8069.62,6,5,8,19,Potential Loyalist,2
2535,15,6,5517.49,9,4,5,18,Potential Loyalist,0
2536,8,6,9145.1,10,4,9,23,Loyal Customers,2
2537,23,11,11743.039999999999,8,7,10,25,Best Customers,2
2538,36,9,11849.7,6,6,10,22,Loyal Customers,2
2539,41,5,5493.46,6,3,5,14,At Risk,0
2540,21,7,7819.73,8,5,8,21,Loyal Customers,2
2541,21,2,3358.87,8,1,2,11,At Risk,0
2542,44,7,10741.16,6,5,10,21,Loyal Customers,2
2543,23,4,5543.46,8,2,5,15,Potential Loyalist,0
2544,33,6,6633.58,7,4,7,18,Potential Loyalist,2
2545,118,3,2916.92,2,1,2,5,Lost Customers,1
2546,20,4,2419.01,8,2,1,11,At Risk,0
2547,185,3,2217.0600000000004,1,1,1,3,Lost Customers,1
2548,4,12,13610.1,10,7,10,27,Best Customers,2
2549,58,4,6211.0,5,2,6,13,At Risk,3
2550,12,5,6139.76,9,3,6,18,Potential Loyalist,0
2551,266,4,4894.98,1,2,4,7,Lost Customers,1
2552,36,6,8603.02,6,4,9,19,Potential Loyalist,2
2553,151,4,3830.0099999999998,1,2,3,6,Lost Customers,1
2554,60,5,4993.71,5,3,4,12,At Risk,0
2555,2,5,7747.14,10,3,8,21,Loyal Customers,2
2556,15,2,1917.48,9,1,1,11,At Risk,0
2557,31,3,5222.06,7,1,5,13,At Risk,0
2558,33,4,5684.29,7,2,5,14,At Risk,0
2559,13,6,3860.65,9,4,3,16,Potential Loyalist,0
2560,46,11,9706.619999999999,6,7,9,22,Loyal Customers,2
2561,2,4,7146.860000000001,10,2,7,19,Potential Loyalist,0
2562,102,7,8220.23,3,5,8,16,Potential Loyalist,3
2563,58,5,4716.139999999999,5,3,4,12,At Risk,0
2564,48,5,2828.34,5,3,2,10,At Risk,1
2565,30,9,11516.51,7,6,10,23,Loyal Customers,2
2566,18,10,8489.6,8,7,8,23,Loyal Customers,2
2567,72,4,5954.21,4,2,6,12,At Risk,3
2568,73,4,3918.87,4,2,3,9,Lost Customers,1
2569,76,7,9585.83,4,5,9,18,Potential Loyalist,3
2570,94,7,7426.35,3,5,7,15,Potential Loyalist,3
2571,46,3,3652.28,6,1,3,10,At Risk,0
2572,80,8,10111.81,3,6,10,19,Potential Loyalist,3
2573,15,4,4088.91,9,2,3,14,At Risk,0
2574,28,9,9973.75,7,6,9,22,Loyal Customers,2
2575,11,5,4119.53,9,3,3,15,Potential Loyalist,0
2576,79,7,8271.03,3,5,8,16,Potential Loyalist,3
2577,94,6,5240.639999999999,3,4,5,12,At Risk,3
2578,39,4,4676.02,6,2,4,12,At Risk,0
2579,50,3,2288.84,5,1,1,7,Lost Customers,1
2580,65,8,9493.86,4,6,9,19,Potential Loyalist,3
2581,135,5,5903.89,2,3,6,11,At Risk,3
2582,53,5,5104.43,5,3,5,13,At Risk,3
2583,93,4,4046.62,3,2,3,8,Lost Customers,1
2584,39,5,3983.61,6,3,3,12,At Risk,0
2585,6,7,7066.38,10,5,7,22,Loyal Customers,2
2586,20,3,3379.79,8,1,2,11,At Risk,0
2587,65,9,9007.27,4,6,9,19,Potential Loyalist,3
2588,179,3,5656.6900000000005,1,1,5,7,Lost Customers,1
2589,68,5,5101.54,4,3,5,12,At Risk,3
2590,51,6,8720.42,5,4,9,18,Potential Loyalist,3
2591,43,6,9027.71,6,4,9,19,Potential Loyalist,2
2592,38,8,11062.61,6,6,10,22,Loyal Customers,2
2593,61,4,3940.27,5,2,3,10,At Risk,1
2594,92,6,9467.470000000001,3,4,9,16,Potential Loyalist,3
2595,45,8,10273.25,6,6,10,22,Loyal Customers,2
2596,73,5,7674.39,4,3,8,15,Potential Loyalist,3
2597,6,6,7670.71,10,4,8,22,Loyal Customers,2
2598,88,5,6570.66,3,3,7,13,At Risk,3
2599,54,6,5641.2699999999995,5,4,5,14,At Risk,3
2600,172,3,4973.54,1,1,4,6,Lost Customers,1
2601,37,8,9798.03,6,6,9,21,Loyal Customers,2
2602,72,7,7403.1900000000005,4,5,7,16,Potential Loyalist,3
2603,15,7,7817.9400000000005,9,5,8,22,Loyal Customers,2
2604,87,6,6086.83,3,4,6,13,At Risk,3
2605,116,5,6656.209999999999,2,3,7,12,At Risk,3
2606,6,10,12338.51,10,7,10,27,Best Customers,2
2607,6,8,7870.34,10,6,8,24,Loyal Customers,2
2608,18,7,4403.82,8,5,3,16,Potential Loyalist,0
2609,188,7,6390.16,1,5,6,12,At Risk,3
2610,113,8,8499.220000000001,2,6,8,16,Potential Loyalist,3
2611,3,7,5700.59,10,5,5,20,Loyal Customers,0
2612,210,2,1924.4700000000003,1,1,1,3,Lost Customers,1
2613,99,5,4933.99,3,3,4,10,At Risk,1
2614,21,4,6322.41,8,2,6,16,Potential Loyalist,0
2615,56,9,13460.630000000001,5,6,10,21,Loyal Customers,3
2616,43,11,13134.119999999999,6,7,10,23,Loyal Customers,2
2617,127,7,10695.449999999999,2,5,10,17,Potential Loyalist,3
2618,8,10,9670.59,10,7,9,26,Best Customers,2
2619,77,2,3869.2699999999995,4,1,3,8,Lost Customers,1
2620,31,8,8317.97,7,6,8,21,Loyal Customers,2
2621,10,7,6926.01,9,5,7,21,Loyal Customers,2
2622,17,7,6595.22,8,5,7,20,Loyal Customers,2
2623,11,4,5764.370000000001,9,2,5,16,Potential Loyalist,0
2624,28,4,4940.76,7,2,4,13,At Risk,0
2625,85,4,3403.67,3,2,2,7,Lost Customers,1
2626,42,4,4263.71,6,2,3,11,At Risk,0
2627,34,6,9321.82,7,4,9,20,Loyal Customers,2
2628,174,4,4668.82,1,2,4,7,Lost Customers,1
2629,45,5,5608.95,6,3,5,14,At Risk,0
2630,63,10,10514.539999999999,4,7,10,21,Loyal Customers,3
2631,28,3,3539.6800000000003,7,1,2,10,At Risk,0
2632,8,4,6590.860000000001,10,2,7,19,Potential Loyalist,0
2633,16,8,10321.12,8,6,10,24,Loyal Customers,2
2634,190,3,2614.21,1,1,2,4,Lost Customers,1
2635,69,8,10781.21,4,6,10,20,Loyal Customers,3
2636,31,3,3411.77,7,1,2,10,At Risk,0
2637,55,11,13895.71,5,7,10,22,Loyal Customers,2
2638,84,9,9133.15,3,6,9,18,Potential Loyalist,3
2639,32,5,7255.96,7,3,7,17,Potential Loyalist,2
2640,68,11,11643.47,4,7,10,21,Loyal Customers,3
2641,12,7,6132.32,9,5,6,20,Loyal Customers,2
2642,21,2,3229.6400000000003,8,1,2,11,At Risk,0
2643,55,3,1897.1999999999998,5,1,1,7,Lost Customers,1
2644,61,2,1697.24,5,1,1,7,Lost Customers,1
2645,33,6,5168.14,7,4,5,16,Potential Loyalist,0
2646,120,5,4987.72,2,3,4,9,Lost Customers,1
2647,18,7,6760.95,8,5,7,20,Loyal Customers,2
2648,36,5,6102.13,6,3,6,15,Potential Loyalist,0
2649,130,4,6633.45,2,2,7,11,At Risk,3
2650,26,6,5688.65,7,4,5,16,Potential Loyalist,0
2651,16,7,9379.39,8,5,9,22,Loyal Customers,2
2652,24,5,7176.639999999999,8,3,7,18,Potential Loyalist,2
2653,4,9,12316.0,10,6,10,26,Best Customers,2
2654,109,9,9905.2,2,6,9,17,Potential Loyalist,3
2655,158,6,8575.35,1,4,9,14,At Risk,3
2656,139,7,9051.86,2,5,9,16,Potential Loyalist,3
2657,183,3,3891.5,1,1,3,5,Lost Customers,1
2658,37,5,3853.98,6,3,3,12,At Risk,0
2659,1,12,11948.48,10,7,10,27,Best Customers,2
2661,9,5,5712.01,9,3,5,17,Potential Loyalist,0
2662,63,9,10546.039999999999,4,6,10,20,Loyal Customers,3
2663,165,5,7423.2300000000005,1,3,7,11,At Risk,3
2664,135,7,6587.43,2,5,7,14,At Risk,3
2665,31,3,5364.68,7,1,5,13,At Risk,0
2666,257,4,4534.9,1,2,4,7,Lost Customers,1
2667,99,5,5817.66,3,3,5,11,At Risk,3
2668,62,5,3342.3,4,3,2,9,Lost Customers,1
2669,49,3,3552.54,5,1,2,8,Lost Customers,1
2670,59,3,3290.68,5,1,2,8,Lost Customers,1
2671,101,7,8811.26,3,5,9,17,Potential Loyalist,3
2672,16,8,8417.05,8,6,8,22,Loyal Customers,2
2673,91,5,4576.389999999999,3,3,4,10,At Risk,1
2674,45,5,6395.9,6,3,6,15,Potential Loyalist,0
2675,96,5,5429.8,3,3,5,11,At Risk,3
2676,6,6,7274.78,10,4,7,21,Loyal Customers,2
2677,28,5,5446.05,7,3,5,15,Potential Loyalist,0
2678,114,5,5004.09,2,3,4,9,Lost Customers,1
2679,86,6,5660.31,3,4,5,12,At Risk,3
2680,17,8,9105.78,8,6,9,23,Loyal Customers,2
2681,51,5,4606.83,5,3,4,12,At Risk,0
2682,39,8,6122.34,6,6,6,18,Potential Loyalist,3
2683,17,6,7829.89,8,4,8,20,Loyal Customers,2
2684,39,9,11938.039999999999,6,6,10,22,Loyal Customers,2
2685,45,6,5323.86,6,4,5,15,Potential Loyalist,0
2686,25,11,13237.88,7,7,10,24,Loyal Customers,2
2687,18,7,6724.23,8,5,7,20,Loyal Customers,2
2688,89,3,3018.69,3,1,2,6,Lost Customers,1
2689,2,5,3956.18,10,3,3,16,Potential Loyalist,0
2690,110,4,5860.55,2,2,6,10,At Risk,3
2691,61,8,8562.05,5,6,9,20,Loyal Customers,3
2692,41,3,1662.12,6,1,1,8,Lost Customers,0
2693,2,6,5128.639999999999,10,4,5,19,Potential Loyalist,0
2694,30,4,2766.09,7,2,2,11,At Risk,0
2695,5,8,10630.04,10,6,10,26,Best Customers,2
2696,152,4,5519.58,1,2,5,8,Lost Customers,1
2697,34,7,6415.43,7,5,6,18,Potential Loyalist,2
2698,13,7,9054.05,9,5,9,23,Loyal Customers,2
2699,61,5,3428.76,5,3,2,10,At Risk,1
2700,72,4,4497.46,4,2,4,10,At Risk,1
2701,53,9,11558.89,5,6,10,21,Loyal Customers,3
2702,20,8,11698.41,8,6,10,24,Loyal Customers,2
2703,20,7,7330.05,8,5,7,20,Loyal Customers,2
2704,236,3,1517.27,1,1,1,3,Lost Customers,1
2705,3,8,10063.4,10,6,10,26,Best Customers,2
2706,124,3,2769.36,2,1,2,5,Lost Customers,1
2707,44,3,3934.6,6,1,3,10,At Risk,0
2708,12,3,3437.08,9,1,2,12,At Risk,0
2709,3,4,3569.92,10,2,2,14,At Risk,0
2710,9,4,3931.54,9,2,3,14,At Risk,0
2711,64,6,6439.08,4,4,6,14,At Risk,3
2712,17,6,6967.02,8,4,7,19,Potential Loyalist,2
2713,1,2,1722.85,10,1,1,12,At Risk,0
2714,9,5,4081.8100000000004,9,3,3,15,Potential Loyalist,0
2715,105,5,6644.62,2,3,7,12,At Risk,3
2716,144,4,4529.24,2,2,4,8,Lost Customers,1
2717,42,9,9904.87,6,6,9,21,Loyal Customers,2
2718,222,6,6050.71,1,4,6,11,At Risk,3
2719,11,3,3061.49,9,1,2,12,At Risk,0
2720,149,4,3710.19,1,2,3,6,Lost Customers,1
2721,115,2,2292.96,2,1,1,4,Lost Customers,1
2722,74,6,4806.32,4,4,4,12,At Risk,1
2723,41,8,10565.119999999999,6,6,10,22,Loyal Customers,2
2724,143,4,4604.3,2,2,4,8,Lost Customers,1
2725,177,4,2094.38,1,2,1,4,Lost Customers,1
2726,28,9,9047.33,7,6,9,22,Loyal Customers,2
2727,50,5,8567.85,5,3,9,17,Potential Loyalist,3
2728,8,8,9659.77,10,6,9,25,Best Customers,2
2729,7,6,8706.47,10,4,9,23,Loyal Customers,2
2730,5,7,4649.51,10,5,4,19,Potential Loyalist,0
2731,4,4,2409.89,10,2,1,13,At Risk,0
2732,17,9,6519.72,8,6,6,20,Loyal Customers,2
2733,29,9,12972.27,7,6,10,23,Loyal Customers,2
2734,56,3,2148.54,5,1,1,7,Lost Customers,1
2735,149,2,1340.77,1,1,1,3,Lost Customers,1
2736,43,5,4311.28,6,3,3,12,At Risk,0
2737,6,9,10510.1,10,6,10,26,Best Customers,2
2738,60,4,4501.1900000000005,5,2,4,11,At Risk,1
2739,243,2,743.0500000000001,1,1,1,3,Lost Customers,1
2740,27,8,10497.95,7,6,10,23,Loyal Customers,2
2741,20,2,1825.0700000000002,8,1,1,10,At Risk,0
2742,96,3,3741.05,3,1,3,7,Lost Customers,1
2743,47,2,2956.8,5,1,2,8,Lost Customers,1
2744,126,3,3148.36,2,1,2,5,Lost Customers,1
2745,268,2,3322.62,1,1,2,4,Lost Customers,1
2746,9,3,3056.2200000000003,9,1,2,12,At Risk,0
2747,15,8,10528.310000000001,9,6,10,25,Best Customers,2
2748,7,4,3952.7,10,2,3,15,Potential Loyalist,0
2749,35,1,1061.56,6,1,1,8,Lost Customers,0
2750,43,11,12349.36,6,7,10,23,Loyal Customers,2
2751,4,8,9856.48,10,6,9,25,Best Customers,2
2752,13,4,5737.59,9,2,5,16,Potential Loyalist,0
2753,68,11,9649.8,4,7,9,20,Loyal Customers,3
2754,187,3,5568.64,1,1,5,7,Lost Customers,1
2755,29,11,10018.130000000001,7,7,9,23,Loyal Customers,2
2756,57,3,3384.1800000000003,5,1,2,8,Lost Customers,1
2757,145,3,3501.37,2,1,2,5,Lost Customers,1
2758,80,3,2230.06,3,1,1,5,Lost Customers,1
2759,111,5,5619.73,2,3,5,10,At Risk,1
2760,32,4,4168.87,7,2,3,12,At Risk,0
2761,8,9,10079.42,10,6,10,26,Best Customers,2
2762,17,8,11096.220000000001,8,6,10,24,Loyal Customers,2
2763,20,9,6496.64,8,6,6,20,Loyal Customers,2
2764,52,3,1639.08,5,1,1,7,Lost Customers,1
2765,47,6,8522.02,5,4,8,17,Potential Loyalist,3
2766,48,6,8740.06,5,4,9,18,Potential Loyalist,3
2767,49,3,2597.41,5,1,2,8,Lost Customers,1
2768,24,6,6811.9400000000005,8,4,7,19,Potential Loyalist,2
2769,47,6,8004.25,5,4,8,17,Potential Loyalist,3
2770,31,9,13728.7,7,6,10,23,Loyal Customers,2
2771,45,5,8579.48,6,3,9,18,Potential Loyalist,3
2772,26,5,5138.68,7,3,5,15,Potential Loyalist,0
2773,5,4,4179.19,10,2,3,15,Potential Loyalist,0
2774,85,5,4479.04,3,3,4,10,At Risk,1
2775,13,6,6201.93,9,4,6,19,Potential Loyalist,0
2776,47,3,2259.63,5,1,1,7,Lost Customers,1
2777,104,6,6216.71,2,4,6,12,At Risk,3
2778,10,5,5669.9,9,3,5,17,Potential Loyalist,0
2779,12,5,6558.76,9,3,7,19,Potential Loyalist,2
2780,3,5,6150.43,10,3,6,19,Potential Loyalist,0
2781,74,4,4131.86,4,2,3,9,Lost Customers,1
2782,171,5,4995.43,1,3,4,8,Lost Customers,1
2783,74,11,9019.44,4,7,9,20,Loyal Customers,3
2784,75,3,2423.2200000000003,4,1,1,6,Lost Customers,1
2785,46,6,9232.95,6,4,9,19,Potential Loyalist,2
2786,4,6,4372.3,10,4,3,17,Potential Loyalist,0
2787,38,6,10014.36,6,4,9,19,Potential Loyalist,2
2788,45,11,17258.940000000002,6,7,10,23,Loyal Customers,2
2789,25,2,2097.73,7,1,1,9,Lost Customers,0
2790,78,3,1799.14,4,1,1,6,Lost Customers,1
2791,15,6,8909.15,9,4,9,22,Loyal Customers,2
2792,219,3,4771.39,1,1,4,6,Lost Customers,1
2793,35,7,9763.37,6,5,9,20,Loyal Customers,2
2794,6,7,7835.25,10,5,8,23,Loyal Customers,2
2795,226,2,2369.69,1,1,1,3,Lost Customers,1
2796,9,7,8157.719999999999,9,5,8,22,Loyal Customers,2
2797,76,6,4583.92,4,4,4,12,At Risk,1
2798,155,5,3433.47,1,3,2,6,Lost Customers,1
2799,30,8,9916.09,7,6,9,22,Loyal Customers,2
2800,42,5,1193.9,6,3,1,10,At Risk,0
2801,23,4,2768.23,8,2,2,12,At Risk,0
2802,173,3,1370.06,1,1,1,3,Lost Customers,1
2803,31,6,6522.64,7,4,6,17,Potential Loyalist,0
2804,59,7,6016.75,5,5,6,16,Potential Loyalist,3
2805,4,5,5915.9,10,3,6,19,Potential Loyalist,0
2806,69,8,8667.06,4,6,9,19,Potential Loyalist,3
2807,354,1,1216.14,1,1,1,3,Lost Customers,1
2808,7,5,6828.29,10,3,7,20,Loyal Customers,2
2809,84,3,2490.58,3,1,1,5,Lost Customers,1
2810,63,6,3670.1800000000003,4,4,3,11,At Risk,1
2811,26,5,4456.35,7,3,4,14,At Risk,0
2812,88,6,8956.25,3,4,9,16,Potential Loyalist,3
2813,205,4,4560.26,1,2,4,7,Lost Customers,1
2814,14,4,4851.34,9,2,4,15,Potential Loyalist,0
2815,28,9,9217.46,7,6,9,22,Loyal Customers,2
2816,9,10,13562.73,9,7,10,26,Best Customers,2
2817,16,3,4046.6099999999997,8,1,3,12,At Risk,0
2818,100,4,5234.29,3,2,5,10,At Risk,1
2819,163,4,5543.02,1,2,5,8,Lost Customers,1
2820,59,7,8152.6900000000005,5,5,8,18,Potential Loyalist,3
2821,52,5,4455.08,5,3,4,12,At Risk,0
2822,12,8,8230.66,9,6,8,23,Loyal Customers,2
2823,13,4,2040.6100000000001,9,2,1,12,At Risk,0
2824,123,6,8837.81,2,4,9,15,Potential Loyalist,3
2825,113,4,4231.89,2,2,3,7,Lost Customers,1
2826,12,12,11244.57,9,7,10,26,Best Customers,2
2827,108,5,4673.13,2,3,4,9,Lost Customers,1
2828,116,2,2446.06,2,1,1,4,Lost Customers,1
2829,145,2,3023.32,2,1,2,5,Lost Customers,1
2830,96,5,4885.5199999999995,3,3,4,10,At Risk,1
2831,15,5,4904.01,9,3,4,16,Potential Loyalist,0
2832,24,8,6485.34,8,6,6,20,Loyal Customers,2
2833,17,6,6437.61,8,4,6,18,Potential Loyalist,0
2834,67,3,3603.6800000000003,4,1,2,7,Lost Customers,1
2835,229,3,1178.37,1,1,1,3,Lost Customers,1
2836,14,9,10868.1,9,6,10,25,Best Customers,2
2837,42,7,9092.1,6,5,9,20,Loyal Customers,2
2838,16,3,2838.62,8,1,2,11,At Risk,0
2839,18,8,7971.99,8,6,8,22,Loyal Customers,2
2840,17,4,3362.7599999999998,8,2,2,12,At Risk,0
2841,17,7,10658.349999999999,8,5,10,23,Loyal Customers,2
2842,40,3,2134.96,6,1,1,8,Lost Customers,0
2843,21,6,6116.0,8,4,6,18,Potential Loyalist,0
2844,24,6,6778.91,8,4,7,19,Potential Loyalist,2
2845,48,8,8539.21,5,6,9,20,Loyal Customers,3
2846,16,3,2298.78,8,1,1,10,At Risk,0
2847,45,7,8251.07,6,5,8,19,Potential Loyalist,2
2848,14,4,5354.429999999999,9,2,5,16,Potential Loyalist,0
2849,116,4,4650.96,2,2,4,8,Lost Customers,1
2850,8,8,7671.88,10,6,8,24,Loyal Customers,2
2851,10,7,8383.77,9,5,8,22,Loyal Customers,2
2852,104,4,5055.13,2,2,4,8,Lost Customers,1
2853,82,8,8836.36,3,6,9,18,Potential Loyalist,3
2854,84,3,3231.58,3,1,2,6,Lost Customers,1
2855,40,2,255.35000000000002,6,1,1,8,Lost Customers,0
2856,7,7,10139.11,10,5,10,25,Best Customers,2
2857,114,6,8974.25,2,4,9,15,Potential Loyalist,3
2858,109,4,6672.94,2,2,7,11,At Risk,3
2859,11,8,6793.56,9,6,7,22,Loyal Customers,2
2860,9,9,13804.79,9,6,10,25,Best Customers,2
2861,74,8,9484.25,4,6,9,19,Potential Loyalist,3
2862,15,5,4816.96,9,3,4,16,Potential Loyalist,0
2863,176,1,544.05,1,1,1,3,Lost Customers,1
2864,18,4,4770.7699999999995,8,2,4,14,At Risk,0
2865,1,7,11030.02,10,5,10,25,Best Customers,2
2866,79,4,4759.37,3,2,4,9,Lost Customers,1
2867,96,5,2866.46,3,3,2,8,Lost Customers,1
2868,26,4,3572.73,7,2,2,11,At Risk,0
2869,117,6,6230.41,2,4,6,12,At Risk,3
2870,110,2,599.88,2,1,1,4,Lost Customers,1
2871,21,6,4852.74,8,4,4,16,Potential Loyalist,0
2872,25,7,7041.0599999999995,7,5,7,19,Potential Loyalist,2
2873,105,3,3244.63,2,1,2,5,Lost Customers,1
2874,61,11,15091.91,5,7,10,22,Loyal Customers,2
2875,36,4,5883.47,6,2,6,14,At Risk,0
2877,42,8,6928.59,6,6,7,19,Potential Loyalist,2
2878,1,3,2319.39,10,1,1,12,At Risk,0
2879,15,8,9983.98,9,6,9,24,Loyal Customers,2
2880,19,8,12780.52,8,6,10,24,Loyal Customers,2
2881,73,6,6506.51,4,4,6,14,At Risk,3
2882,295,2,2515.6800000000003,1,1,1,3,Lost Customers,1
2883,50,7,10571.82,5,5,10,20,Loyal Customers,3
2884,15,7,6721.58,9,5,7,21,Loyal Customers,2
2885,95,9,12055.64,3,6,10,19,Potential Loyalist,3
2886,40,8,8504.95,6,6,8,20,Loyal Customers,2
2887,25,9,10892.99,7,6,10,23,Loyal Customers,2
2888,30,6,7967.07,7,4,8,19,Potential Loyalist,2
2889,106,5,6098.4800000000005,2,3,6,11,At Risk,3
2890,87,6,6579.15,3,4,7,14,At Risk,3
2891,63,7,8583.39,4,5,9,18,Potential Loyalist,3
2892,13,5,6697.78,9,3,7,19,Potential Loyalist,2
2893,60,3,4825.25,5,1,4,10,At Risk,1
2894,87,8,13218.23,3,6,10,19,Potential Loyalist,3
2895,259,2,1390.68,1,1,1,3,Lost Customers,1
2896,195,2,2648.5,1,1,2,4,Lost Customers,1
2897,47,5,4416.799999999999,5,3,4,12,At Risk,0
2898,79,4,4284.31,3,2,3,8,Lost Customers,1
2899,31,6,6188.15,7,4,6,17,Potential Loyalist,0
2900,62,3,4234.34,4,1,3,8,Lost Customers,1
2901,39,7,9512.21,6,5,9,20,Loyal Customers,2
2902,197,2,1591.08,1,1,1,3,Lost Customers,1
2903,27,3,3175.62,7,1,2,10,At Risk,0
2904,24,7,5397.49,8,5,5,18,Potential Loyalist,0
2905,9,4,3343.69,9,2,2,13,At Risk,0
2906,46,4,4835.93,6,2,4,12,At Risk,0
2907,75,7,9679.210000000001,4,5,9,18,Potential Loyalist,3
2908,2,6,3638.18,10,4,3,17,Potential Loyalist,0
2909,84,7,7868.9,3,5,8,16,Potential Loyalist,3
2910,88,7,4188.58,3,5,3,11,At Risk,1
2911,284,2,1875.15,1,1,1,3,Lost Customers,1
2912,47,13,14149.73,5,7,10,22,Loyal Customers,2
2913,90,6,5130.11,3,4,5,12,At Risk,3
2914,13,12,13824.53,9,7,10,26,Best Customers,2
2915,34,7,6896.26,7,5,7,19,Potential Loyalist,2
2916,25,5,5194.54,7,3,5,15,Potential Loyalist,0
2917,149,5,6402.85,1,3,6,10,At Risk,3
2918,52,7,8939.64,5,5,9,19,Potential Loyalist,3
2919,22,6,5710.05,8,4,5,17,Potential Loyalist,0
2920,100,2,2787.82,3,1,2,6,Lost Customers,1
2921,58,5,4820.4,5,3,4,12,At Risk,0
2922,2,4,4732.49,10,2,4,16,Potential Loyalist,0
2923,14,7,6413.18,9,5,6,20,Loyal Customers,2
2924,65,5,5251.5599999999995,4,3,5,12,At Risk,3
2925,94,5,4419.8099999999995,3,3,4,10,At Risk,1
2926,144,4,3211.69,2,2,2,6,Lost Customers,1
2927,100,3,4096.32,3,1,3,7,Lost Customers,1
2928,176,5,6092.18,1,3,6,10,At Risk,3
2929,2,8,9420.43,10,6,9,25,Best Customers,2
2930,72,6,5079.0,4,4,4,12,At Risk,1
2931,58,6,4741.6,5,4,4,13,At Risk,0
2932,20,10,10991.14,8,7,10,25,Best Customers,2
2933,96,5,4806.32,3,3,4,10,At Risk,1
2934,62,6,7094.71,4,4,7,15,Potential Loyalist,3
2935,7,7,4508.01,10,5,4,19,Potential Loyalist,0
2936,60,6,9389.35,5,4,9,18,Potential Loyalist,3
2937,8,7,11473.75,10,5,10,25,Best Customers,2
2938,126,5,7013.27,2,3,7,12,At Risk,3
2939,91,4,3757.8,3,2,3,8,Lost Customers,1
2940,95,7,6758.78,3,5,7,15,Potential Loyalist,3
2941,173,5,4811.55,1,3,4,8,Lost Customers,1
2942,10,7,8857.0,9,5,9,23,Loyal Customers,2
2943,53,6,6774.969999999999,5,4,7,16,Potential Loyalist,3
2944,31,6,4572.33,7,4,4,15,Potential Loyalist,0
2945,50,3,2684.96,5,1,2,8,Lost Customers,1
2946,32,10,9722.73,7,7,9,23,Loyal Customers,2
2947,15,5,4953.820000000001,9,3,4,16,Potential Loyalist,0
2948,112,5,4758.83,2,3,4,9,Lost Customers,1
2949,14,3,1857.76,9,1,1,11,At Risk,0
2950,76,3,1953.15,4,1,1,6,Lost Customers,1
2951,86,9,11002.560000000001,3,6,10,19,Potential Loyalist,3
2952,28,5,6242.1,7,3,6,16,Potential Loyalist,0
2953,76,5,6263.34,4,3,6,13,At Risk,3
2954,7,5,4688.92,10,3,4,17,Potential Loyalist,0
2955,20,8,8309.33,8,6,8,22,Loyal Customers,2
2956,98,7,5810.6900000000005,3,5,5,13,At Risk,3
2957,99,3,3938.5699999999997,3,1,3,7,Lost Customers,1
2958,5,6,5472.64,10,4,5,19,Potential Loyalist,0
2959,135,3,3525.57,2,1,2,5,Lost Customers,1
2960,89,3,5056.1,3,1,4,8,Lost Customers,1
2961,3,6,8983.52,10,4,9,23,Loyal Customers,2
2962,78,3,2837.74,4,1,2,7,Lost Customers,1
2963,214,4,3028.12,1,2,2,5,Lost Customers,1
2964,169,2,3630.46,1,1,2,4,Lost Customers,1
2965,91,6,6158.93,3,4,6,13,At Risk,3
2966,33,5,5009.32,7,3,4,14,At Risk,0
2967,11,3,4699.01,9,1,4,14,At Risk,0
2968,172,7,5052.9,1,5,4,10,At Risk,1
2969,12,6,6455.639999999999,9,4,6,19,Potential Loyalist,0
2970,99,4,4043.88,3,2,3,8,Lost Customers,1
2971,28,3,2449.96,7,1,1,9,Lost Customers,0
2972,57,4,3218.41,5,2,2,9,Lost Customers,1
2973,94,4,3872.73,3,2,3,8,Lost Customers,1
2974,160,2,1166.79,1,1,1,3,Lost Customers,1
2975,170,3,4429.83,1,1,4,6,Lost Customers,1
2976,7,4,6239.15,10,2,6,18,Potential Loyalist,0
2977,10,5,5552.88,9,3,5,17,Potential Loyalist,0
2978,148,3,2701.2200000000003,1,1,2,4,Lost Customers,1
2979,128,3,2299.62,2,1,1,4,Lost Customers,1
2980,16,6,7498.77,8,4,8,20,Loyal Customers,2
2981,53,6,3001.28,5,4,2,11,At Risk,1
2982,118,7,8987.33,2,5,9,16,Potential Loyalist,3
2983,130,5,7256.57,2,3,7,12,At Risk,3
2984,159,4,6016.24,1,2,6,9,Lost Customers,3
2985,39,10,10664.07,6,7,10,23,Loyal Customers,2
2986,29,8,8549.550000000001,7,6,9,22,Loyal Customers,2
2987,53,4,4102.19,5,2,3,10,At Risk,1
2988,33,8,8349.34,7,6,8,21,Loyal Customers,2
2989,71,9,11757.14,4,6,10,20,Loyal Customers,3
2990,15,7,5394.23,9,5,5,19,Potential Loyalist,0
2991,76,6,5559.9800000000005,4,4,5,13,At Risk,3
2992,10,8,10530.96,9,6,10,25,Best Customers,2
2993,10,7,10087.74,9,5,10,24,Loyal Customers,2
2994,16,3,719.38,8,1,1,10,At Risk,0
2995,11,5,5069.75,9,3,4,16,Potential Loyalist,0
2996,22,3,4774.51,8,1,4,13,At Risk,0
2997,32,6,5293.91,7,4,5,16,Potential Loyalist,0
2998,67,3,4629.21,4,1,4,9,Lost Customers,1
2999,9,11,12745.98,9,7,10,26,Best Customers,2
3000,43,4,4848.29,6,2,4,12,At Risk,0
3001,105,4,4664.8,2,2,4,8,Lost Customers,1
3002,45,6,5117.8099999999995,6,4,5,15,Potential Loyalist,0
3003,112,9,7885.54,2,6,8,16,Potential Loyalist,3
3004,114,5,5048.79,2,3,4,9,Lost Customers,1
3005,190,3,3682.5499999999997,1,1,3,5,Lost Customers,1
3006,31,4,5912.1,7,2,6,15,Potential Loyalist,0
3007,4,7,8547.34,10,5,9,24,Loyal Customers,2
3008,6,6,7710.66,10,4,8,22,Loyal Customers,2
3009,89,4,4421.04,3,2,4,9,Lost Customers,1
3010,111,4,3636.6800000000003,2,2,3,7,Lost Customers,1
3011,36,4,3080.8,6,2,2,10,At Risk,0
3012,4,6,9204.57,10,4,9,23,Loyal Customers,2
3013,5,9,8161.56,10,6,8,24,Loyal Customers,2
3014,20,9,8691.039999999999,8,6,9,23,Loyal Customers,2
3015,47,9,13737.05,5,6,10,21,Loyal Customers,3
3016,1,5,7991.99,10,3,8,21,Loyal Customers,2
3017,177,4,5289.49,1,2,5,8,Lost Customers,1
3018,20,5,3833.35,8,3,3,14,At Risk,0
3019,65,3,4258.98,4,1,3,8,Lost Customers,1
3020,23,11,10879.6,8,7,10,25,Best Customers,2
3021,61,7,6493.42,5,5,6,16,Potential Loyalist,3
3022,32,5,3884.79,7,3,3,13,At Risk,0
3023,133,4,2119.85,2,2,1,5,Lost Customers,1
3024,51,1,1769.64,5,1,1,7,Lost Customers,1
3025,126,2,2263.49,2,1,1,4,Lost Customers,1
3026,93,5,4489.49,3,3,4,10,At Risk,1
3027,32,5,3296.91,7,3,2,12,At Risk,0
3028,54,4,5030.69,5,2,4,11,At Risk,1
3029,122,4,5099.51,2,2,5,9,Lost Customers,1
3030,25,7,5700.4,7,5,5,17,Potential Loyalist,0
3031,3,5,6455.51,10,3,6,19,Potential Loyalist,0
3032,41,7,10767.02,6,5,10,21,Loyal Customers,2
3033,159,2,2523.2,1,1,1,3,Lost Customers,1
3034,49,5,5496.76,5,3,5,13,At Risk,3
3035,39,5,4522.24,6,3,4,13,At Risk,0
3036,157,5,8620.53,1,3,9,13,At Risk,3
3037,186,3,2449.3,1,1,1,3,Lost Customers,1
3038,47,6,5268.26,5,4,5,14,At Risk,3
3039,70,9,8652.35,4,6,9,19,Potential Loyalist,3
3041,125,2,3469.37,2,1,2,5,Lost Customers,1
3042,12,6,6916.03,9,4,7,20,Loyal Customers,2
3043,12,4,4497.96,9,2,4,15,Potential Loyalist,0
3044,5,9,10768.18,10,6,10,26,Best Customers,2
3045,66,5,6795.04,4,3,7,14,At Risk,3
3046,229,4,5855.92,1,2,6,9,Lost Customers,3
3047,35,5,6712.39,6,3,7,16,Potential Loyalist,3
3048,5,12,13272.89,10,7,10,27,Best Customers,2
3049,44,3,3596.57,6,1,2,9,Lost Customers,0
3050,67,9,12410.86,4,6,10,20,Loyal Customers,3
3051,141,4,5849.7,2,2,6,10,At Risk,3
3052,55,2,1216.02,5,1,1,7,Lost Customers,1
3053,194,4,3823.21,1,2,3,6,Lost Customers,1
3054,3,5,7022.29,10,3,7,20,Loyal Customers,2
3055,59,10,10643.23,5,7,10,22,Loyal Customers,2
3056,20,4,4165.67,8,2,3,13,At Risk,0
3057,29,7,9733.55,7,5,9,21,Loyal Customers,2
3058,25,5,8188.639999999999,7,3,8,18,Potential Loyalist,2
3059,143,2,3898.92,2,1,3,6,Lost Customers,1
3060,30,11,14609.22,7,7,10,24,Loyal Customers,2
3061,60,9,8604.59,5,6,9,20,Loyal Customers,3
3062,47,6,6083.87,5,4,6,15,Potential Loyalist,3
3063,93,4,1240.62,3,2,1,6,Lost Customers,1
3064,56,7,6989.68,5,5,7,17,Potential Loyalist,3
3065,6,5,5665.26,10,3,5,18,Potential Loyalist,0
3066,165,4,3756.25,1,2,3,6,Lost Customers,1
3067,40,6,7095.87,6,4,7,17,Potential Loyalist,3
3068,80,6,5197.79,3,4,5,12,At Risk,3
3069,71,3,3104.7999999999997,4,1,2,7,Lost Customers,1
3070,120,4,1927.42,2,2,1,5,Lost Customers,1
3071,159,4,3954.99,1,2,3,6,Lost Customers,1
3072,68,7,7712.87,4,5,8,17,Potential Loyalist,3
3073,252,3,3426.95,1,1,2,4,Lost Customers,1
3074,11,7,8822.95,9,5,9,23,Loyal Customers,2
3075,82,6,5704.8,3,4,5,12,At Risk,3
3076,210,4,4105.89,1,2,3,6,Lost Customers,1
3077,17,7,8452.62,8,5,8,21,Loyal Customers,2
3078,170,3,2490.95,1,1,1,3,Lost Customers,1
3079,132,4,4030.71,2,2,3,7,Lost Customers,1
3080,5,9,10388.83,10,6,10,26,Best Customers,2
3081,107,6,8311.18,2,4,8,14,At Risk,3
3082,17,5,4508.030000000001,8,3,4,15,Potential Loyalist,0
3083,70,6,4366.12,4,4,3,11,At Risk,1
3084,16,6,7652.58,8,4,8,20,Loyal Customers,2
3085,26,4,3400.58,7,2,2,11,At Risk,0
3086,12,9,9791.77,9,6,9,24,Loyal Customers,2
3087,85,6,6584.210000000001,3,4,7,14,At Risk,3
3088,4,7,6701.71,10,5,7,22,Loyal Customers,2
3089,28,4,6196.13,7,2,6,15,Potential Loyalist,0
3090,199,5,6006.22,1,3,6,10,At Risk,3
3091,308,2,1434.48,1,1,1,3,Lost Customers,1
3092,161,3,3324.14,1,1,2,4,Lost Customers,1
3093,69,9,10362.369999999999,4,6,10,20,Loyal Customers,3
3094,162,7,6633.12,1,5,7,13,At Risk,3
3095,37,5,7352.31,6,3,7,16,Potential Loyalist,3
3096,16,3,5023.0599999999995,8,1,4,13,At Risk,0
3097,61,3,3076.92,5,1,2,8,Lost Customers,1
3098,39,4,5235.47,6,2,5,13,At Risk,0
3099,84,2,3105.12,3,1,2,6,Lost Customers,1
3100,21,4,5579.87,8,2,5,15,Potential Loyalist,0
3101,62,3,3983.01,4,1,3,8,Lost Customers,1
3102,107,4,6100.75,2,2,6,10,At Risk,3
3103,60,8,9084.18,5,6,9,20,Loyal Customers,3
3104,50,5,5021.030000000001,5,3,4,12,At Risk,0
3105,11,6,6820.6,9,4,7,20,Loyal Customers,2
3106,200,4,3539.25,1,2,2,5,Lost Customers,1
3107,96,3,3819.28,3,1,3,7,Lost Customers,1
3108,54,7,10194.970000000001,5,5,10,20,Loyal Customers,3
3109,170,5,6150.85,1,3,6,10,At Risk,3
3110,18,3,2064.77,8,1,1,10,At Risk,0
3111,49,4,3370.16,5,2,2,9,Lost Customers,1
3112,12,8,8006.59,9,6,8,23,Loyal Customers,2
3113,110,8,10192.61,2,6,10,18,Potential Loyalist,3
3114,141,3,3412.05,2,1,2,5,Lost Customers,1
3115,196,5,6326.07,1,3,6,10,At Risk,3
3116,99,5,4665.98,3,3,4,10,At Risk,1
3117,26,9,12615.48,7,6,10,23,Loyal Customers,2
3118,13,9,14065.03,9,6,10,25,Best Customers,2
3119,6,4,4368.56,10,2,3,15,Potential Loyalist,0
3120,21,7,7351.7,8,5,7,20,Loyal Customers,2
3121,49,6,6379.44,5,4,6,15,Potential Loyalist,3
3122,144,4,5814.280000000001,2,2,5,9,Lost Customers,1
3123,1,4,3733.72,10,2,3,15,Potential Loyalist,0
3124,39,3,2085.18,6,1,1,8,Lost Customers,0
3125,10,4,4529.16,9,2,4,15,Potential Loyalist,0
3126,41,7,8883.54,6,5,9,20,Loyal Customers,2
3127,36,4,5836.78,6,2,6,14,At Risk,0
3128,105,5,5753.62,2,3,5,10,At Risk,1
3129,17,5,6405.030000000001,8,3,6,17,Potential Loyalist,0
3130,1,5,6539.6,10,3,6,19,Potential Loyalist,0
3131,18,8,7333.7,8,6,7,21,Loyal Customers,2
3132,24,5,5502.29,8,3,5,16,Potential Loyalist,0
3133,12,6,7335.610000000001,9,4,7,20,Loyal Customers,2
3134,65,7,10273.18,4,5,10,19,Potential Loyalist,3
3135,122,7,7539.8099999999995,2,5,8,15,Potential Loyalist,3
3136,26,4,4905.76,7,2,4,13,At Risk,0
3137,117,6,4587.58,2,4,4,10,At Risk,1
3138,70,4,5084.3,4,2,5,11,At Risk,1
3139,12,3,2633.05,9,1,2,12,At Risk,0
3140,41,3,2714.79,6,1,2,9,Lost Customers,0
3141,71,7,3596.67,4,5,2,11,At Risk,1
3142,13,4,4004.87,9,2,3,14,At Risk,0
3143,21,11,10532.28,8,7,10,25,Best Customers,2
3144,65,3,1975.27,4,1,1,6,Lost Customers,1
3145,69,6,7219.03,4,4,7,15,Potential Loyalist,3
3146,55,7,9778.95,5,5,9,19,Potential Loyalist,3
3147,4,6,5237.77,10,4,5,19,Potential Loyalist,0
3148,56,6,6033.4,5,4,6,15,Potential Loyalist,3
3149,23,3,3636.56,8,1,3,12,At Risk,0
3150,88,7,3787.1800000000003,3,5,3,11,At Risk,1
3151,14,9,11451.18,9,6,10,25,Best Customers,2
3152,12,6,5683.73,9,4,5,18,Potential Loyalist,0
3153,128,5,8533.27,2,3,9,14,At Risk,3
3154,15,7,6780.46,9,5,7,21,Loyal Customers,2
3155,44,4,2692.7400000000002,6,2,2,10,At Risk,0
3156,5,3,3087.91,10,1,2,13,At Risk,0
3157,11,8,10424.25,9,6,10,25,Best Customers,2
3158,17,6,7721.6900000000005,8,4,8,20,Loyal Customers,2
3159,26,2,3527.29,7,1,2,10,At Risk,0
3160,53,4,5296.11,5,2,5,12,At Risk,0
3161,84,1,792.9,3,1,1,5,Lost Customers,1
3162,111,2,2734.17,2,1,2,5,Lost Customers,1
3163,15,6,5066.64,9,4,4,17,Potential Loyalist,0
3164,99,5,6151.66,3,3,6,12,At Risk,3
3165,78,8,8775.91,4,6,9,19,Potential Loyalist,3
3166,48,6,8665.7,5,4,9,18,Potential Loyalist,3
3167,74,3,3266.8,4,1,2,7,Lost Customers,1
3168,92,4,6708.369999999999,3,2,7,12,At Risk,3
3169,1,7,6806.93,10,5,7,22,Loyal Customers,2
3170,45,6,6884.95,6,4,7,17,Potential Loyalist,3
3171,76,3,3111.56,4,1,2,7,Lost Customers,1
3172,56,4,3093.31,5,2,2,9,Lost Customers,1
3173,46,6,8425.04,6,4,8,18,Potential Loyalist,3
3174,25,6,4986.21,7,4,4,15,Potential Loyalist,0
3175,261,3,3044.7200000000003,1,1,2,4,Lost Customers,1
3176,25,9,7167.2699999999995,7,6,7,20,Loyal Customers,2
3177,69,6,4811.72,4,4,4,12,At Risk,1
3178,30,5,6357.4800000000005,7,3,6,16,Potential Loyalist,0
3179,269,1,1148.64,1,1,1,3,Lost Customers,1
3180,146,2,2298.81,2,1,1,4,Lost Customers,1
3181,10,6,8160.14,9,4,8,21,Loyal Customers,2
3182,85,4,1732.02,3,2,1,6,Lost Customers,1
3183,12,8,6607.77,9,6,7,22,Loyal Customers,2
3184,69,8,9258.6,4,6,9,19,Potential Loyalist,3
3185,19,7,6809.12,8,5,7,20,Loyal Customers,2
3186,20,5,5875.91,8,3,6,17,Potential Loyalist,0
3187,64,5,5489.099999999999,4,3,5,12,At Risk,3
3188,117,5,3932.31,2,3,3,8,Lost Customers,1
3189,57,2,200.7,5,1,1,7,Lost Customers,1
3190,93,8,5692.24,3,6,5,14,At Risk,3
3191,8,8,9402.43,10,6,9,25,Best Customers,2
3192,189,4,4871.5199999999995,1,2,4,7,Lost Customers,1
3193,11,6,5155.41,9,4,5,18,Potential Loyalist,0
3194,87,2,1922.0300000000002,3,1,1,5,Lost Customers,1
3195,50,8,7261.0,5,6,7,18,Potential Loyalist,3
3196,51,7,7505.92,5,5,8,18,Potential Loyalist,3
3197,4,5,5284.57,10,3,5,18,Potential Loyalist,0
3198,102,4,5693.18,3,2,5,10,At Risk,1
3199,14,8,10703.79,9,6,10,25,Best Customers,2
3200,40,5,4865.6900000000005,6,3,4,13,At Risk,0
3201,22,7,7757.7300000000005,8,5,8,21,Loyal Customers,2
3202,12,8,9341.0,9,6,9,24,Loyal Customers,2
3203,8,3,4714.8099999999995,10,1,4,15,Potential Loyalist,0
3204,35,8,10981.449999999999,6,6,10,22,Loyal Customers,2
3205,97,6,6054.93,3,4,6,13,At Risk,3
3206,76,7,7842.21,4,5,8,17,Potential Loyalist,3
3207,82,5,3751.87,3,3,3,9,Lost Customers,1
3208,54,7,9142.74,5,5,9,19,Potential Loyalist,3
3209,10,4,3112.43,9,2,2,13,At Risk,0
3210,10,5,3992.06,9,3,3,15,Potential Loyalist,0
3211,36,3,3667.73,6,1,3,10,At Risk,0
3212,100,7,12326.75,3,5,10,18,Potential Loyalist,3
3213,69,5,4363.18,4,3,3,10,At Risk,1
3214,69,4,4838.349999999999,4,2,4,10,At Risk,1
3215,67,7,11950.24,4,5,10,19,Potential Loyalist,3
3216,1,4,3366.82,10,2,2,14,At Risk,0
3217,9,11,10733.56,9,7,10,26,Best Customers,2
3218,217,4,3574.66,1,2,2,5,Lost Customers,1
3219,28,8,7191.65,7,6,7,20,Loyal Customers,2
3220,41,8,7616.3,6,6,8,20,Loyal Customers,2
3221,112,9,11096.32,2,6,10,18,Potential Loyalist,3
3222,16,2,2179.35,8,1,1,10,At Risk,0
3223,36,7,8203.23,6,5,8,19,Potential Loyalist,2
3224,52,9,8518.72,5,6,8,19,Potential Loyalist,3
3225,9,7,7505.34,9,5,8,22,Loyal Customers,2
3226,21,4,1217.42,8,2,1,11,At Risk,0
3227,4,6,6029.25,10,4,6,20,Loyal Customers,0
3228,41,7,9815.41,6,5,9,20,Loyal Customers,2
3230,70,5,5698.38,4,3,5,12,At Risk,3
3231,2,6,6398.62,10,4,6,20,Loyal Customers,0
3232,9,13,13451.28,9,7,10,26,Best Customers,2
3233,81,3,2477.0699999999997,3,1,1,5,Lost Customers,1
3234,150,2,2358.0,1,1,1,3,Lost Customers,1
3235,223,1,1163.89,1,1,1,3,Lost Customers,1
3237,177,7,8413.77,1,5,8,14,At Risk,3
3238,30,5,3916.44,7,3,3,13,At Risk,0
3239,3,6,4374.75,10,4,3,17,Potential Loyalist,0
3240,54,9,10954.07,5,6,10,21,Loyal Customers,3
3241,8,6,9227.58,10,4,9,23,Loyal Customers,2
3242,50,7,10813.44,5,5,10,20,Loyal Customers,3
3243,164,4,4005.26,1,2,3,6,Lost Customers,1
3244,22,4,3578.91,8,2,2,12,At Risk,0
3245,94,6,5577.43,3,4,5,12,At Risk,3
3246,100,5,6186.950000000001,3,3,6,12,At Risk,3
3247,45,8,7108.27,6,6,7,19,Potential Loyalist,2
3248,59,4,3305.23,5,2,2,9,Lost Customers,1
3249,34,7,10781.65,7,5,10,22,Loyal Customers,2
3250,86,6,4950.37,3,4,4,11,At Risk,1
3251,8,11,9947.98,10,7,9,26,Best Customers,2
3252,19,7,5910.41,8,5,6,19,Potential Loyalist,2
3253,6,3,4743.31,10,1,4,15,Potential Loyalist,0
3254,32,6,6956.21,7,4,7,18,Potential Loyalist,2
3255,3,6,7050.41,10,4,7,21,Loyal Customers,2
3256,13,10,12399.539999999999,9,7,10,26,Best Customers,2
3257,7,3,5121.28,10,1,5,16,Potential Loyalist,0
3258,18,8,11196.13,8,6,10,24,Loyal Customers,2
3259,33,2,1027.94,7,1,1,9,Lost Customers,0
3260,125,3,3833.56,2,1,3,6,Lost Customers,1
3261,39,6,5630.11,6,4,5,15,Potential Loyalist,0
3262,2,10,9899.64,10,7,9,26,Best Customers,2
3263,24,5,4721.62,8,3,4,15,Potential Loyalist,0
3264,24,8,9097.93,8,6,9,23,Loyal Customers,2
3265,89,7,3458.83,3,5,2,10,At Risk,1
3266,72,7,6947.21,4,5,7,16,Potential Loyalist,3
3267,89,6,7867.97,3,4,8,15,Potential Loyalist,3
3268,133,6,8610.78,2,4,9,15,Potential Loyalist,3
3269,36,4,4857.44,6,2,4,12,At Risk,0
3270,123,5,7135.8099999999995,2,3,7,12,At Risk,3
3271,91,4,3156.63,3,2,2,7,Lost Customers,1
3272,296,1,569.56,1,1,1,3,Lost Customers,1
3273,66,7,10472.26,4,5,10,19,Potential Loyalist,3
3274,31,5,3450.3,7,3,2,12,At Risk,0
3275,5,4,2826.83,10,2,2,14,At Risk,0
3276,81,5,6419.18,3,3,6,12,At Risk,3
3277,38,5,5868.16,6,3,6,15,Potential Loyalist,0
3278,23,5,5194.07,8,3,5,16,Potential Loyalist,0
3279,298,1,1071.23,1,1,1,3,Lost Customers,1
3280,135,8,11763.69,2,6,10,18,Potential Loyalist,3
3281,60,2,2044.08,5,1,1,7,Lost Customers,1
3282,17,4,4534.85,8,2,4,14,At Risk,0
3283,45,6,7803.8,6,4,8,18,Potential Loyalist,3
3284,279,6,5886.76,1,4,6,11,At Risk,3
3285,20,5,4672.63,8,3,4,15,Potential Loyalist,0
3286,10,10,9898.29,9,7,9,25,Best Customers,2
3287,77,3,3694.7200000000003,4,1,3,8,Lost Customers,1
3288,33,6,8748.24,7,4,9,20,Loyal Customers,2
3289,70,5,7683.389999999999,4,3,8,15,Potential Loyalist,3
3290,3,8,9719.34,10,6,9,25,Best Customers,2
3291,47,4,3946.9500000000003,5,2,3,10,At Risk,1
3292,302,1,60.34,1,1,1,3,Lost Customers,1
3293,1,5,4716.33,10,3,4,17,Potential Loyalist,0
3294,63,4,6769.75,4,2,7,13,At Risk,3
3295,20,8,10279.81,8,6,10,24,Loyal Customers,2
3296,65,11,8887.0,4,7,9,20,Loyal Customers,3
3297,59,6,4162.96,5,4,3,12,At Risk,0
3298,5,5,6502.58,10,3,6,19,Potential Loyalist,0
3299,31,5,4560.97,7,3,4,14,At Risk,0
3300,16,6,8221.25,8,4,8,20,Loyal Customers,2
3301,43,5,4630.47,6,3,4,13,At Risk,0
3302,21,4,2141.3599999999997,8,2,1,11,At Risk,0
3303,21,5,4834.35,8,3,4,15,Potential Loyalist,0
3304,79,10,11128.31,3,7,10,20,Loyal Customers,3
3305,40,2,306.78999999999996,6,1,1,8,Lost Customers,0
3306,41,5,6945.6,6,3,7,16,Potential Loyalist,3
3307,17,5,6066.91,8,3,6,17,Potential Loyalist,0
3308,68,3,3436.83,4,1,2,7,Lost Customers,1
3309,25,5,5485.79,7,3,5,15,Potential Loyalist,0
3310,52,5,5062.860000000001,5,3,4,12,At Risk,0
3311,66,4,3921.49,4,2,3,9,Lost Customers,1
3312,7,4,3943.69,10,2,3,15,Potential Loyalist,0
3313,55,6,6335.93,5,4,6,15,Potential Loyalist,3
3314,59,6,6475.13,5,4,6,15,Potential Loyalist,3
3315,2,7,8032.110000000001,10,5,8,23,Loyal Customers,2
3316,21,2,2608.09,8,1,2,11,At Risk,0
3317,88,4,3299.45,3,2,2,7,Lost Customers,1
3318,152,4,5363.35,1,2,5,8,Lost Customers,1
3319,23,7,7042.889999999999,8,5,7,20,Loyal Customers,2
3320,138,10,10109.98,2,7,10,19,Potential Loyalist,3
3321,97,3,2952.52,3,1,2,6,Lost Customers,1
3322,142,3,3034.55,2,1,2,5,Lost Customers,1
3323,191,3,4290.13,1,1,3,5,Lost Customers,1
3324,32,7,10846.51,7,5,10,22,Loyal Customers,2
3325,46,5,5709.18,6,3,5,14,At Risk,0
3326,30,13,14078.19,7,7,10,24,Loyal Customers,2
3327,57,7,5776.01,5,5,5,15,Potential Loyalist,3
3328,41,4,3511.62,6,2,2,10,At Risk,0
3329,19,4,3348.29,8,2,2,12,At Risk,0
3330,23,8,8810.21,8,6,9,23,Loyal Customers,2
3331,37,5,7702.42,6,3,8,17,Potential Loyalist,3
3332,6,6,6577.57,10,4,7,21,Loyal Customers,2
3333,192,5,5296.389999999999,1,3,5,9,Lost Customers,1
3334,74,8,5742.35,4,6,5,15,Potential Loyalist,3
3335,4,6,4498.03,10,4,4,18,Potential Loyalist,0
3336,75,6,9153.34,4,4,9,17,Potential Loyalist,3
3337,7,8,8265.62,10,6,8,24,Loyal Customers,2
3338,5,3,1464.71,10,1,1,12,At Risk,0
3339,39,5,4095.33,6,3,3,12,At Risk,0
3340,114,6,6462.47,2,4,6,12,At Risk,3
3341,50,4,3646.81,5,2,3,10,At Risk,1
3342,101,7,6736.7,3,5,7,15,Potential Loyalist,3
3343,79,5,4892.030000000001,3,3,4,10,At Risk,1
3344,11,7,6236.96,9,5,6,20,Loyal Customers,2
3345,32,5,3926.35,7,3,3,13,At Risk,0
3346,49,3,2794.14,5,1,2,8,Lost Customers,1
3347,108,5,5387.86,2,3,5,10,At Risk,1
3348,130,3,2749.69,2,1,2,5,Lost Customers,1
3349,222,5,6639.07,1,3,7,11,At Risk,3
3350,39,6,9352.56,6,4,9,19,Potential Loyalist,2
3351,40,6,7191.88,6,4,7,17,Potential Loyalist,3
3352,38,6,5357.0199999999995,6,4,5,15,Potential Loyalist,0
3353,31,7,5270.16,7,5,5,17,Potential Loyalist,0
3354,183,2,3213.07,1,1,2,4,Lost Customers,1
3355,1,5,5543.530000000001,10,3,5,18,Potential Loyalist,0
3356,5,5,6281.6900000000005,10,3,6,19,Potential Loyalist,0
3357,36,4,3897.31,6,2,3,11,At Risk,0
3358,38,6,7750.18,6,4,8,18,Potential Loyalist,3
3359,98,4,2920.95,3,2,2,7,Lost Customers,1
3360,58,8,6162.1900000000005,5,6,6,17,Potential Loyalist,3
3361,45,6,8548.95,6,4,9,19,Potential Loyalist,2
3362,87,3,1983.8400000000001,3,1,1,5,Lost Customers,1
3363,5,6,6443.93,10,4,6,20,Loyal Customers,0
3364,121,5,5647.75,2,3,5,10,At Risk,1
3365,72,6,5971.06,4,4,6,14,At Risk,3
3366,45,4,4591.95,6,2,4,12,At Risk,0
3367,83,6,8647.67,3,4,9,16,Potential Loyalist,3
3368,30,5,5971.18,7,3,6,16,Potential Loyalist,0
3369,77,6,6850.6900000000005,4,4,7,15,Potential Loyalist,3
3370,43,6,6721.32,6,4,7,17,Potential Loyalist,3
3371,42,9,8400.31,6,6,8,20,Loyal Customers,2
3372,32,6,7238.88,7,4,7,18,Potential Loyalist,2
3373,45,5,6773.370000000001,6,3,7,16,Potential Loyalist,3
3374,2,4,6246.4400000000005,10,2,6,18,Potential Loyalist,0
3375,13,8,8710.18,9,6,9,24,Loyal Customers,2
3376,94,5,4239.54,3,3,3,9,Lost Customers,1
3377,78,7,6701.91,4,5,7,16,Potential Loyalist,3
3378,56,4,4651.77,5,2,4,11,At Risk,1
3379,21,6,8165.43,8,4,8,20,Loyal Customers,2
3380,64,5,6088.51,4,3,6,13,At Risk,3
3381,196,5,7129.37,1,3,7,11,At Risk,3
3382,20,10,10347.49,8,7,10,25,Best Customers,2
3383,30,5,6055.67,7,3,6,16,Potential Loyalist,0
3384,248,5,5706.6,1,3,5,9,Lost Customers,1
3385,55,3,2629.8199999999997,5,1,2,8,Lost Customers,1
3386,8,4,3908.11,10,2,3,15,Potential Loyalist,0
3387,83,8,10309.67,3,6,10,19,Potential Loyalist,3
3388,104,7,8811.73,2,5,9,16,Potential Loyalist,3
3389,55,6,6107.86,5,4,6,15,Potential Loyalist,3
3390,19,4,4362.93,8,2,3,13,At Risk,0
3391,20,5,3719.61,8,3,3,14,At Risk,0
3392,75,1,574.64,4,1,1,6,Lost Customers,1
3393,3,5,4896.49,10,3,4,17,Potential Loyalist,0
3394,20,5,5926.59,8,3,6,17,Potential Loyalist,0
3395,10,7,7852.11,9,5,8,22,Loyal Customers,2
3396,72,2,586.65,4,1,1,6,Lost Customers,1
3397,90,2,2179.35,3,1,1,5,Lost Customers,1
3398,66,5,4872.530000000001,4,3,4,11,At Risk,1
3399,38,4,5815.25,6,2,5,13,At Risk,0
3400,27,4,2797.13,7,2,2,11,At Risk,0
3401,67,6,6768.02,4,4,7,15,Potential Loyalist,3
3402,13,9,10700.79,9,6,10,25,Best Customers,2
3403,134,4,4516.0199999999995,2,2,4,8,Lost Customers,1
3404,52,4,4414.0,5,2,4,11,At Risk,1
3405,53,9,9157.710000000001,5,6,9,20,Loyal Customers,3
3406,47,10,12169.87,5,7,10,22,Loyal Customers,2
3407,19,7,7901.58,8,5,8,21,Loyal Customers,2
3408,23,5,4452.78,8,3,4,15,Potential Loyalist,0
3409,74,7,7353.55,4,5,7,16,Potential Loyalist,3
3410,242,3,2965.8900000000003,1,1,2,4,Lost Customers,1
3411,31,7,11320.22,7,5,10,22,Loyal Customers,2
3412,45,3,4328.72,6,1,3,10,At Risk,0
3413,26,4,6325.24,7,2,6,15,Potential Loyalist,0
3414,163,3,4674.02,1,1,4,6,Lost Customers,1
3415,103,5,7794.34,3,3,8,14,At Risk,3
3416,123,3,2184.42,2,1,1,4,Lost Customers,1
3417,96,8,8566.05,3,6,9,18,Potential Loyalist,3
3418,91,5,4643.87,3,3,4,10,At Risk,1
3419,6,3,4108.62,10,1,3,14,At Risk,0
3420,6,11,13885.45,10,7,10,27,Best Customers,2
3421,29,9,11268.79,7,6,10,23,Loyal Customers,2
3422,33,5,5634.98,7,3,5,15,Potential Loyalist,0
3423,78,4,3061.5,4,2,2,8,Lost Customers,1
3424,154,2,2940.52,1,1,2,4,Lost Customers,1
3425,19,6,6287.46,8,4,6,18,Potential Loyalist,0
3426,46,6,8405.57,6,4,8,18,Potential Loyalist,3
3427,2,8,12523.17,10,6,10,26,Best Customers,2
3428,92,1,1274.93,3,1,1,5,Lost Customers,1
3429,122,4,3323.9500000000003,2,2,2,6,Lost Customers,1
3430,64,7,5809.24,4,5,5,14,At Risk,3
3431,29,10,12673.97,7,7,10,24,Loyal Customers,2
3432,107,8,9201.85,2,6,9,17,Potential Loyalist,3
3433,1,10,10471.84,10,7,10,27,Best Customers,2
3434,65,5,5720.52,4,3,5,12,At Risk,3
3435,137,5,6384.02,2,3,6,11,At Risk,3
3436,23,7,8090.11,8,5,8,21,Loyal Customers,2
3437,103,5,6930.87,3,3,7,13,At Risk,3
3438,175,5,5208.01,1,3,5,9,Lost Customers,1
3439,75,6,5868.21,4,4,6,14,At Risk,3
3440,33,5,5026.7,7,3,4,14,At Risk,0
3441,139,5,4864.98,2,3,4,9,Lost Customers,1
3442,204,4,4629.6,1,2,4,7,Lost Customers,1
3443,30,6,6729.01,7,4,7,18,Potential Loyalist,2
3444,40,2,3281.0299999999997,6,1,2,9,Lost Customers,0
3445,15,6,7992.1900000000005,9,4,8,21,Loyal Customers,2
3446,5,2,1028.53,10,1,1,12,At Risk,0
3447,84,10,11696.67,3,7,10,20,Loyal Customers,3
3448,11,5,5257.04,9,3,5,17,Potential Loyalist,0
3449,150,4,4223.1900000000005,1,2,3,6,Lost Customers,1
3450,99,6,7360.77,3,4,7,14,At Risk,3
3451,16,9,7139.17,8,6,7,21,Loyal Customers,2
3452,3,2,2808.6800000000003,10,1,2,13,At Risk,0
3453,73,6,6294.04,4,4,6,14,At Risk,3
3454,116,5,5561.38,2,3,5,10,At Risk,1
3455,10,6,4674.13,9,4,4,17,Potential Loyalist,0
3456,64,3,4206.89,4,1,3,8,Lost Customers,1
3457,98,3,2726.46,3,1,2,6,Lost Customers,1
3458,109,3,4554.71,2,1,4,7,Lost Customers,1
3459,67,3,4164.04,4,1,3,8,Lost Customers,1
3460,81,8,10701.84,3,6,10,19,Potential Loyalist,3
3461,137,7,8401.21,2,5,8,15,Potential Loyalist,3
3462,22,5,5392.75,8,3,5,16,Potential Loyalist,0
3463,58,4,3021.68,5,2,2,9,Lost Customers,1
3465,73,9,8992.41,4,6,9,19,Potential Loyalist,3
3466,69,3,2421.71,4,1,1,6,Lost Customers,1
3467,6,6,8292.41,10,4,8,22,Loyal Customers,2
3468,2,6,6837.77,10,4,7,21,Loyal Customers,2
3469,39,3,2349.65,6,1,1,8,Lost Customers,0
3470,3,8,14126.25,10,6,10,26,Best Customers,2
3471,149,4,4637.4800000000005,1,2,4,7,Lost Customers,1
3472,6,6,6900.7,10,4,7,21,Loyal Customers,2
3473,13,4,5487.64,9,2,5,16,Potential Loyalist,0
3474,72,5,4654.08,4,3,4,11,At Risk,1
3475,4,4,3785.92,10,2,3,15,Potential Loyalist,0
3476,51,5,2254.2599999999998,5,3,1,9,Lost Customers,1
3477,65,7,8317.98,4,5,8,17,Potential Loyalist,3
3478,30,6,6445.49,7,4,6,17,Potential Loyalist,0
3479,32,6,6015.17,7,4,6,17,Potential Loyalist,0
3480,17,4,4659.76,8,2,4,14,At Risk,0
3481,55,7,4988.41,5,5,4,14,At Risk,3
3482,28,8,11842.05,7,6,10,23,Loyal Customers,2
3483,118,6,8078.03,2,4,8,14,At Risk,3
3484,80,6,8406.81,3,4,8,15,Potential Loyalist,3
3485,26,2,2250.79,7,1,1,9,Lost Customers,0
3486,10,4,4722.08,9,2,4,15,Potential Loyalist,0
3487,11,3,3715.32,9,1,3,13,At Risk,0
3488,18,2,2167.79,8,1,1,10,At Risk,0
3489,109,6,8300.15,2,4,8,14,At Risk,3
3490,167,5,4739.7,1,3,4,8,Lost Customers,1
3491,190,4,3151.67,1,2,2,5,Lost Customers,1
3492,81,3,4141.43,3,1,3,7,Lost Customers,1
3493,94,6,10053.82,3,4,9,16,Potential Loyalist,3
3494,5,4,5122.71,10,2,5,17,Potential Loyalist,0
3495,14,7,8626.65,9,5,9,23,Loyal Customers,2
3496,257,4,4725.38,1,2,4,7,Lost Customers,1
3497,53,3,3744.0699999999997,5,1,3,9,Lost Customers,1
3498,128,6,5177.0599999999995,2,4,5,11,At Risk,3
3499,52,7,7673.4800000000005,5,5,8,18,Potential Loyalist,3
3500,145,6,4922.41,2,4,4,10,At Risk,1
